en	te
I can assure you that you are wrong.	మీరు తప్పు అని నేను మీకు భరోసా ఇవ్వగలను.
I don't know what you want me to do.	నేను ఏమి చేయాలనుకుంటున్నానో నాకు తెలియదు.
Tom doesn't want to do his homework right now.	టామ్ ప్రస్తుతం తన ఇంటి పని చేయాలనుకోవడం లేదు.
Tom is a talented young man.	టామ్ ప్రతిభావంతులైన యువకుడు.
Where are you going	మీరు ఎక్కడికి వెళుతున్నారు
I'm a very lucky man.	నేను చాలా అదృష్టవంతుడిని.
I used to be poor like you.	నేను మీలాగే పేదవాడిని.
He must be a good walker to have walked such a long distance.	ఇంత దూరం నడవడానికి అతను మంచి వాకర్ అయి ఉండాలి.
It can  enhance creativity by encouraging players to think outside the box and explore different strategies and ideas.	ఇది పెట్టె వెలుపల ఆలోచించడానికి మరియు విభిన్న వ్యూహాలు మరియు ఆలోచనలను అన్వేషించడానికి ఆటగాళ్లను ప్రోత్సహించడం ద్వారా సృజనాత్మకతను మెరుగుపరుస్తుంది.
Naga Venkata Sai is a multi-talented individual with a diverse range of skills.	నాగ వెంకట సాయి విభిన్న నైపుణ్యాలు కలిగిన బహుముఖ ప్రజ్ఞాశాలి.
A group of foreigners arrived in Edo, in other words Tokyo.	విదేశీయుల బృందం ఎడోకు చేరుకుంది, మరో మాటలో చెప్పాలంటే టోక్యో.
Tom is a schemer.	టామ్ ఒక స్కీమర్.
All the children like you.	పిల్లలందరూ మీకు ఇష్టం.
He came back home a while ago.	అతను కొద్దిసేపటి క్రితం ఇంటికి తిరిగి వచ్చాడు.
A vibrant city with a rich cultural heritage and a thriving economy.	గొప్ప సాంస్కృతిక వారసత్వం మరియు అభివృద్ధి చెందుతున్న ఆర్థిక వ్యవస్థతో శక్తివంతమైన నగరం.
Tom taught me to play chess.	టామ్ నాకు చెస్ ఆడటం నేర్పించాడు.
She wrote the book about people she visited.	ఆమె సందర్శించిన వ్యక్తుల గురించి ఆమె పుస్తకం రాసింది.
I wish she had come last night.	ఆమె గత రాత్రి వచ్చిందని నేను కోరుకుంటున్నాను.
I don't know why I even bother anymore.	నేను ఇక ఎందుకు బాధపడుతున్నానో నాకు తెలియదు.
actor	నటుడు
Why are you yawning?	మీరు ఎందుకు ఆవలిస్తున్నారు?
The time will come when she'll regret it.	ఆమె చింతిస్తున్న సమయం వస్తుంది.
This is our decision.	ఇది మా నిర్ణయం.
I recognized him immediately.	నేను వెంటనే అతన్ని గుర్తించాను.
It's going to be a long trip.	ఇది సుదీర్ఘ యాత్ర కానుంది.
He was wearing a tuxedo.	అతను తక్సేడో ధరించాడు.
Tom fell through the ice.	టామ్ మంచు గుండా పడిపోయాడు.
Maybe we should stop at a gas station to ask for directions.	ఆదేశాలు అడగడానికి మనం గ్యాస్ స్టేషన్ వద్ద ఆగాలి.
Tom doesn't want this.	టామ్‌కు ఇది అక్కరలేదు.
How does he do this?	అతను దీన్ని ఎలా చేస్తాడు?
They were all actors.	వారంతా నటులు.
Don't ruin our fun.	మా సరదాని నాశనం చేయవద్దు.
It  is one of the most visited pilgrimage sites in the world.	ప్రపంచంలో అత్యధికంగా సందర్శించే తీర్థయాత్రలలో ఇది ఒకటి.
house	ఇల్లు
Nobody complained.	ఎవరూ ఫిర్యాదు చేయలేదు.
Don't you watch movies?	మీరు సినిమాలు చూడలేదా?
Give a thief enough rope and he'll hang himself.	ఒక దొంగకు తగినంత తాడు ఇవ్వండి మరియు అతను ఉరి వేసుకుంటాడు.
He didn't get caught.	అతను చిక్కుకోలేదు.
Tom's handwriting is unreadable.	టామ్ చేతివ్రాత చదవలేనిది.
I let him get the credit.	నేను అతనిని క్రెడిట్ పొందటానికి అనుమతించాను.
Tom was smart enough to escape.	టామ్ తప్పించుకునేంత తెలివైనవాడు.
What's the worst thing that could happen?	జరిగే చెత్త విషయం ఏమిటి?
Tom's sister paved the way for him to become a lawyer.	టామ్ సోదరి అతనికి న్యాయవాదిగా మారడానికి మార్గం సుగమం చేసింది.
The Normans conquered England in 1066.	నార్మన్లు 1066 లో ఇంగ్లాండ్‌ను జయించారు.
Tom asked me how many countries I'd visited.	నేను ఎన్ని దేశాలను సందర్శించాను అని టామ్ నన్ను అడిగాడు.
I'll go if you will.	మీరు కోరుకుంటే నేను వెళ్తాను.
Tom will always remember Mary.	టామ్ ఎల్లప్పుడూ మేరీని గుర్తుంచుకుంటాడు.
Tom didn't want to admit he was scared.	టామ్ తాను భయపడ్డానని ఒప్పుకోవటానికి ఇష్టపడలేదు.
Tom wants to say hello.	టామ్ హలో చెప్పాలనుకుంటున్నాడు.
S. P. B sang over 40,000 songs in various languages and was one of the most versatile and popular singers of his time.	S. P. B వివిధ భాషలలో 40,000 పాటలు పాడారు మరియు అతని కాలంలోని అత్యంత బహుముఖ మరియు ప్రసిద్ధ గాయకులలో ఒకరు.
I did what Tom asked me to do.	టామ్ నన్ను అడిగినట్లు నేను చేసాను.
Tom is still an amateur.	టామ్ ఇప్పటికీ te త్సాహిక వ్యక్తి.
The damage was covered by insurance.	నష్టం భీమా పరిధిలోకి వచ్చింది.
I used to cry a lot.	నేను చాలా ఏడుస్తాను.
What's your son's name?	మీ కొడుకు పేరు ఏమిటి?
Did you really dream about me?	మీరు నిజంగా నా గురించి కలలు కన్నారా?
Tom got in his car and left.	టామ్ తన కారులో దిగి వెళ్ళిపోయాడు.
The only spice Tom puts on meat is pepper.	టామ్ మాంసం మీద ఉంచే మసాలా మిరియాలు మాత్రమే.
Tom was stupid enough to challenge Mary to a game of chess.	టామ్ తెలివితక్కువవాడు, చెస్ ఆటకు మేరీని సవాలు చేసేవాడు.
What makes you think that I'm against that?	నేను దీనికి వ్యతిరేకం అని మీరు ఏమనుకుంటున్నారు?
President Monroe was a slave-owner.	అధ్యక్షుడు మన్రో బానిస యజమాని.
I'll miss everyone.	నేను అందరినీ కోల్పోతాను.
He's a weird guy.	అతను విచిత్రమైన వ్యక్తి.
Tom's paralyzed.	టామ్ స్తంభించిపోయాడు.
Which umbrella is yours?	ఏ గొడుగు మీది?
She is learning how to drive a car.	ఆమె కారు నడపడం నేర్చుకుంటుంది.
It may rain tomorrow.	రేపు వర్షం పడవచ్చు.
What would you like to buy your mother for her birthday?	మీ తల్లి పుట్టినరోజు కోసం మీరు ఏమి కొనాలనుకుంటున్నారు?
Why did that have to happen to us?	అది మనకు ఎందుకు జరగాలి?
Tom is still learning the rules.	టామ్ ఇప్పటికీ నియమాలను నేర్చుకుంటున్నాడు.
I haven't accomplished anything yet.	నేను ఇంకా ఏమీ సాధించలేదు.
Tom refused to help Mary.	టామ్ మేరీకి సహాయం చేయడానికి నిరాకరించాడు.
I have to take my medicine every six hours.	ప్రతి ఆరు గంటలకు నా medicine షధం తీసుకోవాలి.
I had a good time.	నాకు మంచి సమయం వచ్చింది.
I wonder if Tom would really do something like that.	టామ్ నిజంగా అలాంటిదే చేస్తాడా అని నేను ఆశ్చర్యపోతున్నాను.
There's the bell.	గంట ఉంది.
I don't want to break your heart.	నేను మీ హృదయాన్ని విచ్ఛిన్నం చేయాలనుకోవడం లేదు.
They are bound together by common interests.	వారు సాధారణ ప్రయోజనాలతో కట్టుబడి ఉంటారు.
Tom put the map on the table.	టామ్ మ్యాప్‌ను టేబుల్‌పై ఉంచాడు.
We kept together for safety.	మేము భద్రత కోసం కలిసి ఉంచాము.
I've read somewhere that it's not true.	ఇది నిజం కాదని నేను ఎక్కడో చదివాను.
Tom heard everything they said.	టామ్ వారు చెప్పినవన్నీ విన్నారు.
Tom's death was mysterious.	టామ్ మరణం మర్మమైనది.
The rice crop is poor this year.	ఈ సంవత్సరం వరి పంట పేలవంగా ఉంది.
I've been expecting your call.	నేను మీ కాల్‌ను ఆశిస్తున్నాను.
It was eighty meters long.	ఇది ఎనభై మీటర్ల పొడవు.
Was Tom the one who told you to do that?	టామ్ మీకు అలా చేయమని చెప్పాడా?
Tom loved the song even though the lyrics were in a language he didn't understand.	సాహిత్యం తనకు అర్థం కాని భాషలో ఉన్నప్పటికీ టామ్ ఈ పాటను ఇష్టపడ్డాడు.
Tom was the only one not sitting.	టామ్ మాత్రమే కూర్చోలేదు.
You shouldn't trust anything Tom says.	టామ్ చెప్పిన దేన్నీ మీరు నమ్మకూడదు.
How many people know about this?	దీని గురించి ఎంత మందికి తెలుసు?
The worst is behind us.	చెత్త మన వెనుక ఉంది.
ram kills ravana.	రాముడు రావణుడిని చంపాడు.
Rajinikanth is a popular Indian actor who has worked in Tamil, Telugu, Hindi, Kannada, and other Indian languages films.	రజనీకాంత్ తమిళం, తెలుగు, హిందీ, కన్నడ మరియు ఇతర భారతీయ భాషల చిత్రాలలో పనిచేసిన ప్రముఖ భారతీయ నటుడు.
I closed the door.	నేను తలుపు మూసాను.
I have nothing to do this afternoon.	ఈ మధ్యాహ్నం నాకు ఏమీ లేదు.
I want you to have a copy of this.	దీని కాపీని మీరు కలిగి ఉండాలని నేను కోరుకుంటున్నాను.
I hate this game.	నేను ఈ ఆటను ద్వేషిస్తున్నాను.
Is it OK if I eat one of these apples?	నేను ఈ ఆపిల్ల ఒకటి తింటే సరేనా?
Let's talk about your work.	మీ పని గురించి మాట్లాడుకుందాం.
The air conditioner doesn't work.	ఎయిర్ కండీషనర్ పనిచేయదు.
I like your apartment.	నేను మీ అపార్ట్మెంట్ను ఇష్టపడుతున్నాను.
Can you please tell me where the restaurant is?	దయచేసి రెస్టారెంట్ ఎక్కడ ఉందో చెప్పగలరా?
You've never had a boyfriend, have you?	మీకు ఎప్పుడూ బాయ్‌ఫ్రెండ్ లేరు, లేదా?
You saw them, didn't you?	మీరు వాటిని చూశారు, లేదా?
We drank a lot of coffee.	మేము చాలా కాఫీ తాగాము.
My parents won't let me date.	నా తల్లిదండ్రులు నన్ను డేటింగ్ చేయనివ్వరు.
I am not a foodie.	నేను భోజనప్రియుడిని కాదు.
I don't remember mailing the letter.	నాకు లేఖ మెయిల్ చేయడం గుర్తులేదు.
Tom showed Mary the scar on his leg.	టామ్ మేరీకి తన కాలు మీద ఉన్న మచ్చను చూపించాడు.
I feel very guilty.	నేను చాలా అపరాధభావంతో ఉన్నాను.
Tom and Mary understood each other.	టామ్ మరియు మేరీ ఒకరినొకరు అర్థం చేసుకున్నారు.
I got up at 8 o'clock today.	నేను ఈ రోజు 8 గంటలకు లేచాను.
Does that window open?	ఆ విండో తెరుచుకుంటుందా?
I know that Tom was first.	టామ్ మొదటివాడు అని నాకు తెలుసు.
Please keep this a secret.	దయచేసి దీన్ని రహస్యంగా ఉంచండి.
Tom says his left leg hurts.	తన ఎడమ కాలు బాధిస్తుందని టామ్ చెప్పాడు.
My father says he's planning to buy me a horse.	నా తండ్రి నాకు గుర్రాన్ని కొనాలని యోచిస్తున్నట్లు చెప్పారు.
Didn't you know that Tom was planning to go to Australia?	టామ్ ఆస్ట్రేలియా వెళ్ళాలని యోచిస్తున్నాడని మీకు తెలియదా?
Free books available	ఉచిత పుస్తకాలు అందుబాటులో ఉన్నాయి
King loves forestation.	రాజుకు అడవులు అంటే చాలా ఇష్టం
Don't you feel cold?	మీకు చలి అనిపించలేదా?
Tom and Mary are planning to get a divorce.	టామ్ మరియు మేరీ విడాకులు తీసుకోవాలని యోచిస్తున్నారు.
They are going to send up a rocket.	వారు రాకెట్ పంపబోతున్నారు.
Tom has written down a list of things we need to do.	టామ్ మనం చేయవలసిన పనుల జాబితాను వ్రాశాడు.
It caught my eye.	ఇది నా దృష్టిని ఆకర్షించింది.
Tom says Mary wasn't at the meeting.	ఈ సమావేశంలో మేరీ లేడని టామ్ చెప్పారు.
When are we going to use it?	మేము దానిని ఎప్పుడు ఉపయోగించబోతున్నాం?
This street used to have another name.	ఈ వీధికి మరొక పేరు ఉండేది.
I want you to put out that cigarette.	మీరు ఆ సిగరెట్ బయట పెట్టాలని నేను కోరుకుంటున్నాను.
I didn't know you were going to be there.	మీరు అక్కడ ఉండబోతున్నారని నాకు తెలియదు.
Tom is probably still hiding.	టామ్ బహుశా ఇప్పటికీ దాక్కున్నాడు.
Let's not fool ourselves.	మనల్ని మనం మోసం చేసుకోనివ్వండి.
Tom died in his seventies.	టామ్ తన డెబ్బైలలో మరణించాడు.
The party finished at nine.	పార్టీ తొమ్మిదికి ముగిసింది.
Tom has never driven a car before.	టామ్ ఇంతకు ముందెన్నడూ కారు నడపలేదు.
Tom can't afford to buy a yacht.	టామ్ ఒక పడవ కొనడానికి భరించలేడు.
Why pay when you can get it for free?	మీరు ఉచితంగా పొందగలిగినప్పుడు ఎందుకు చెల్లించాలి?
Several ships are stuck in sea ice in Antarctica.	అంటార్కిటికాలో అనేక నౌకలు సముద్రపు మంచులో చిక్కుకున్నాయి.
We're a little early.	మేము కొంచెం ముందుగానే ఉన్నాము.
That man is dead.	ఆ మనిషి చనిపోయాడు.
Tom is between jobs.	టామ్ ఉద్యోగాల మధ్య ఉన్నాడు.
Tom didn't need to explain it to me.	టామ్ దానిని నాకు వివరించాల్సిన అవసరం లేదు.
The group was made up of four young men.	ఈ బృందంలో నలుగురు యువకులు ఉన్నారు.
How many times a year do you go skiing?	సంవత్సరానికి ఎన్నిసార్లు మీరు స్కీయింగ్‌కు వెళతారు?
Tom and Mary left alone.	టామ్ మరియు మేరీ ఒంటరిగా ఉన్నారు.
I don't care what people think.	ప్రజలు ఏమనుకుంటున్నారో నేను పట్టించుకోను.
Whales feed on small fish.	తిమింగలాలు చిన్న చేపలను తింటాయి.
I helped.	నేను సహాయం చేసాను.
I'll call back soon.	నేను త్వరలో తిరిగి పిలుస్తాను.
It's always darkest before the dawn.	తెల్లవారేముందు ఎప్పుడూ చీకటిగానే ఉంటుంది.
Tom can't even write his own name yet.	టామ్ ఇంకా తన పేరును కూడా వ్రాయలేడు.
Why can't Tom leave?	టామ్ ఎందుకు వెళ్ళలేడు?
Tom was one of my better students.	టామ్ నా మంచి విద్యార్థులలో ఒకడు.
She drives an imported car.	ఆమె దిగుమతి చేసుకున్న కారును నడుపుతుంది.
Tom wanted me to do that for him.	టామ్ నేను అతని కోసం అలా చేయాలనుకున్నాను.
I won't let anybody hurt you.	మిమ్మల్ని ఎవరూ బాధపెట్టనివ్వను.
It is a prime residential area that is known for its upscale homes, restaurants, and shopping centers.	ఇది ఉన్నత స్థాయి గృహాలు, రెస్టారెంట్లు మరియు షాపింగ్ కేంద్రాలకు ప్రసిద్ధి చెందిన ప్రధాన నివాస ప్రాంతం.
You've probably forgotten about it already.	మీరు ఇప్పటికే దాని గురించి మరచిపోయారు.
I know you can't wait.	మీరు వేచి ఉండలేరని నాకు తెలుసు.
Tom put on his black suit and white tie.	టామ్ తన బ్లాక్ సూట్ మరియు వైట్ టై ధరించాడు.
What is the best concert you've ever been to?	మీరు ఇప్పటివరకు చేసిన ఉత్తమ కచేరీ ఏమిటి?
I had to drop out of college and get a job.	నేను కాలేజీ నుండి తప్పుకొని ఉద్యోగం పొందవలసి వచ్చింది.
Tom is seldom home.	టామ్ చాలా అరుదుగా ఇంట్లోనే ఉంటాడు.
Is that enough?	అది సరిపోతుందా?
Tom looked both ways before crossing the road.	టామ్ రోడ్డు దాటడానికి ముందు రెండు మార్గాలు చూశాడు.
Would you like a glass of water?	మీరు ఒక గ్లాసు నీరు కావాలనుకుంటున్నారా?
The poor girl went blind.	పేద అమ్మాయి అంధురాలైంది.
Telugu is known as italian of the east.	తెలుగును ఇటాలియన్ ఆఫ్ ది ఈస్ట్ అని పిలుస్తారు.
Sold	విక్రయించబడింది
Are you still interested in working for us?	మా కోసం పనిచేయడానికి మీకు ఇంకా ఆసక్తి ఉందా?
It's there now.	ఇది ఇప్పుడు ఉంది.
Whether you believe it or not, I want to get this thing over with as much as you do.	మీరు నమ్మినా, చేయకపోయినా, నేను మీరు చేసినంత మాత్రాన ఈ విషయాన్ని పొందాలనుకుంటున్నాను.
Could you tell me where Tom is?	టామ్ ఎక్కడ ఉన్నారో మీరు నాకు చెప్పగలరా?
Tom thinks we're dead.	మేము చనిపోయామని టామ్ భావిస్తాడు.
Where were you yesterday?	నిన్న నువ్వు ఎక్కడ ఉన్నావు?
We were eating apples.	మేము ఆపిల్ల తింటున్నాము.
Tom said you were busy.	టామ్ మీరు బిజీగా ఉన్నారని చెప్పారు.
Tom shouted at us in a gruff voice.	టామ్ చిరాకు గొంతులో మా వైపు అరిచాడు.
I value my privacy.	నా గోప్యతకు నేను విలువ ఇస్తున్నాను.
All of the men were dressed similarly to Tom.	పురుషులందరూ టామ్ మాదిరిగానే దుస్తులు ధరించారు.
plants	మొక్కలు
Her predictions have come true.	ఆమె అంచనాలు నిజమయ్యాయి.
Turn it off.	దాన్ని ఆపివేయండి.
I'll see what else needs to be done.	ఇంకా ఏమి చేయాలో నేను చూస్తాను.
They traveled together.	వారు కలిసి ప్రయాణించారు.
Tom wasn't working for me.	టామ్ నా కోసం పని చేయలేదు.
Tom wanted me to help him.	టామ్ నేను అతనికి సహాయం చేయాలనుకున్నాను.
This will take some time.	దీనికి కొంత సమయం పడుతుంది.
Tom wasn't smiling when he entered the room.	గదిలోకి ప్రవేశించినప్పుడు టామ్ నవ్వలేదు.
girl	అమ్మాయి
I didn't know Tom was at home.	టామ్ ఇంట్లో ఉన్నట్లు నాకు తెలియదు.
Are you good at remembering faces?	మీరు ముఖాలను గుర్తుంచుకోవడంలో మంచివా?
Tom hit the ball so hard he split the bat.	టామ్ బంతిని గట్టిగా కొట్టాడు, అతను బ్యాట్ను విభజించాడు.
I was very excited.	నేను చాలా ఉత్సాహంగా ఉన్నాను.
I knew this would be hard for you.	ఇది మీకు కష్టమని నాకు తెలుసు.
My grandfather has gray hair.	నా తాతకు బూడిద జుట్టు ఉంది.
Don't Tom and Mary work together?	టామ్ మరియు మేరీ కలిసి పనిచేయలేదా?
I have things on my mind.	నా మనస్సులో విషయాలు ఉన్నాయి.
Tom let me stay with Mary.	టామ్ నన్ను మేరీతో కలిసి ఉండనివ్వండి.
You recovered quickly.	మీరు త్వరగా కోలుకున్నారు.
Sunil is an ultimate comedian.	సునీల్ అంతిమ హాస్యనటుడు.
What are you planning on doing?	మీరు ఏమి చేయాలనుకుంటున్నారు?
How many English words do you know?	మీకు ఎన్ని ఆంగ్ల పదాలు తెలుసు?
Why didn't you tell me all this before?	ఇవన్నీ మీరు ఇంతకు ముందు ఎందుకు నాకు చెప్పలేదు?
That sounded weird.	అది విచిత్రంగా అనిపించింది.
Meeting Tom was quite an experience for me.	టామ్‌ను కలవడం నాకు చాలా అనుభవం.
Tom had absolutely no idea what to do.	టామ్కు ఏమి చేయాలో ఖచ్చితంగా తెలియదు.
Shreya Ghoshal is a very popular and talented Indian playback singer.	శ్రేయా ఘోషల్ చాలా ప్రజాదరణ పొందిన మరియు ప్రతిభావంతులైన భారతీయ నేపథ్య గాయని.
It's likely a mistake.	ఇది పొరపాటు.
I told Tom you'd wait.	నేను వేచి ఉండాలని టామ్ కి చెప్పాను.
Tom wants to end this.	టామ్ దీనిని అంతం చేయాలనుకుంటున్నాడు.
telugu grammer	తెలుగు వ్యాకరణం
Can I offer a suggestion?	నేను సలహా ఇవ్వవచ్చా?
Where do I sign up?	నేను ఎక్కడ సైన్ అప్ చేయాలి?
Do you do anything else?	మీరు మరేదైనా చేస్తున్నారా?
They're green.	అవి ఆకుపచ్చగా ఉన్నాయి.
It's a pity that I have no ear for music.	నాకు సంగీతానికి చెవి లేదు.
There isn't anywhere else to park.	పార్క్ చేయడానికి మరెక్కడా లేదు.
Tom visited Mary.	టామ్ మేరీని సందర్శించాడు.
Tom is stuck.	టామ్ ఇరుక్కుపోయాడు.
You're standing on my foot.	మీరు నా పాదాల మీద నిలబడి ఉన్నారు.
They took Tom to the hospital to have his stomach pumped because he ate something poisonous.	టామ్ విషపూరితమైన ఏదో తిన్నందున అతని కడుపు పంప్ చేయటానికి వారు ఆసుపత్రికి తీసుకువెళ్లారు.
You're an excellent writer.	మీరు అద్భుతమైన రచయిత.
We're not accusing you of anything.	మేము మీపై ఏమీ ఆరోపణలు చేయడం లేదు.
I woke up three times during the night.	నేను రాత్రి సమయంలో మూడుసార్లు మేల్కొన్నాను.
Why did you want to speak to me?	మీరు నాతో ఎందుకు మాట్లాడాలనుకున్నారు?
Tom locked his doors.	టామ్ తన తలుపులు లాక్ చేశాడు.
I think I feel better.	నేను బాగున్నాను.
What can it be?	అది ఏమిటి?
The girl I wanted to marry married somebody else.	నేను వివాహం చేసుకోవాలనుకున్న అమ్మాయి వేరొకరిని వివాహం చేసుకుంది.
There's not enough time to eat now.	ఇప్పుడు తినడానికి తగినంత సమయం లేదు.
It's not known how many of them survived.	వారిలో ఎంతమంది ప్రాణాలతో బయటపడ్డారో తెలియదు.
I see the dog.	నేను కుక్కను చూస్తాను.
He often gets sick.	అతను తరచుగా అనారోగ్యానికి గురవుతాడు.
Our train arrived on time.	మా రైలు సమయానికి వచ్చింది.
Tom doesn't have many books.	టామ్ వద్ద చాలా పుస్తకాలు లేవు.
Why didn't you tell us there was a witness?	సాక్షి ఉందని మీరు మాకు ఎందుకు చెప్పలేదు?
I am planning to visit Kyoto, and Nara as well.	నేను క్యోటో, మరియు నారాలను కూడా సందర్శించాలని ఆలోచిస్తున్నాను.
The burglar came into the house through this door.	దొంగ ఈ తలుపు ద్వారా ఇంట్లోకి వచ్చాడు.
Tom doesn't want to leave.	టామ్ వదిలి వెళ్ళడం ఇష్టం లేదు.
I do think people will use it.	ప్రజలు దీనిని ఉపయోగిస్తారని నేను అనుకుంటున్నాను.
His death was a great loss to our country.	ఆయన మరణం మన దేశానికి ఎంతో నష్టమే.
I don't think that everyone is here yet.	అందరూ ఇంకా ఇక్కడ ఉన్నారని నేను అనుకోను.
If you want quality, pay for it.	మీకు నాణ్యత కావాలంటే, దాని కోసం చెల్లించండి.
The water was ice cold.	నీరు మంచు చల్లగా ఉంది.
I don't care what will become of me.	నాలో ఏమి జరుగుతుందో నేను పట్టించుకోను.
Don't come dressed like bums.	బంస్ లాగా దుస్తులు ధరించవద్దు.
Don't take their word for it.	దాని కోసం వారి మాటను తీసుకోకండి.
Indian	భారతీయుడు
We go fishing together once in a while.	మేము ఒక్కసారి కలిసి చేపలు పట్టడానికి వెళ్తాము.
Tom doesn't like competition.	టామ్‌కు పోటీ నచ్చలేదు.
Tom didn't know what Mary needed to do.	మేరీ ఏమి చేయాలో టామ్కు తెలియదు.
Available	అందుబాటులో ఉంది
How about going out for lunch?	భోజనానికి బయటికి వెళ్లడం ఎలా?
His legs are long.	అతని కాళ్ళు పొడవుగా ఉన్నాయి.
We're going to be here all afternoon.	మేము మధ్యాహ్నం అంతా ఇక్కడే ఉండబోతున్నాం.
Tom knows the rules.	టామ్‌కు నియమాలు తెలుసు.
The two answers are both correct.	రెండు సమాధానాలు రెండూ సరైనవి.
Tom asked me to carry his suitcase.	టామ్ తన సూట్‌కేస్‌ను తీసుకెళ్లమని అడిగాడు.
I like honey.	నాకు తేనె అంటే ఇష్టం.
Tom is most likely eating now.	టామ్ ఇప్పుడు ఎక్కువగా తినడం.
I didn't eat anything else.	నేను వేరే ఏమీ తినలేదు.
We've been helping Tom.	మేము టామ్‌కు సహాయం చేస్తున్నాము.
Stop protecting me.	నన్ను రక్షించడం ఆపు.
Mary doesn't want to end up being an old maid.	మేరీ పాత పనిమనిషిగా ఉండటానికి ఇష్టపడదు.
What do you think this is?	ఇది ఏమిటి?
Asia is roughly four times the size of Europe.	ఆసియా యూరప్ కంటే నాలుగు రెట్లు ఎక్కువ.
Tom said he didn't know how to swim very well.	టామ్ తనకు బాగా ఈత కొట్టడం తెలియదని చెప్పాడు.
I know I deserve this.	నేను దీనికి అర్హుడని నాకు తెలుసు.
We have nothing in common.	మాకు ఉమ్మడిగా ఏమీ లేదు.
How much money do you think Tom makes?	టామ్ ఎంత డబ్బు సంపాదించాడని మీరు అనుకుంటున్నారు?
You shouldn't let him get away with cheating.	మీరు అతన్ని మోసంతో తప్పించుకోకూడదు.
I have cut my finger.	నేను నా వేలు కత్తిరించాను.
You live here alone, don't you?	మీరు ఇక్కడ ఒంటరిగా నివసిస్తున్నారు, లేదా?
Tom is a hot-blooded individual.	టామ్ హాట్ బ్లడెడ్ వ్యక్తి.
He got up at eight in the morning.	అతను ఉదయం ఎనిమిది గంటలకు లేచాడు.
It was impossible to find an answer.	సమాధానం కనుగొనడం అసాధ్యం.
I'll never forget going to Hawaii with her.	ఆమెతో హవాయికి వెళ్లడాన్ని నేను ఎప్పటికీ మర్చిపోలేను.
Let's leave as soon as he gets back.	అతను తిరిగి రాగానే బయలుదేరదాం.
We go to school together.	మేమిద్దరం కలిసి బడికి వెళ్తాం.
I like your work.	మీ పని నాకు చాలా ఇష్టం.
What are the languages do you know?	మీకు తెలిసిన భాషలు ఏమిటి?
Let's sit down on the bench.	బెంచ్ మీద కూర్చుందాం.
She gave him a clock.	ఆమె అతనికి ఒక గడియారం ఇచ్చింది.
Tom and I walk to school together every morning.	టామ్ మరియు నేను ప్రతి ఉదయం కలిసి పాఠశాలకు నడుస్తాము.
You should marry Tom.	మీరు టామ్‌ను వివాహం చేసుకోవాలి.
It's obsolete.	ఇది వాడుకలో లేదు.
Tom has a high fever.	టామ్‌కు అధిక జ్వరం ఉంది.
I'm afraid I'll be a burden to you.	నేను మీకు భారం అవుతాను అని భయపడుతున్నాను.
We weren't prepared for what happened.	ఏమి జరిగిందో మేము సిద్ధంగా లేము.
He is a man of his word.	అతను తన మాటలోని వ్యక్తి.
Take this chair. It's sturdy.	ఈ కుర్చీ తీసుకోండి.
i am very tired	నేను బాగా అలసిపోయాను
Tom is eating a cake.	టామ్ కేక్ తింటున్నాడు.
Tom said he wondered if Mary and I'd be able to do that by ourselves.	టామ్ మాట్లాడుతూ మేరీ మరియు నేను దానిని మనమే చేయగలమా అని ఆలోచిస్తున్నానని చెప్పాడు.
I know how it feels.	ఇది ఎలా అనిపిస్తుందో నాకు తెలుసు.
I remember saying that.	నేను చెప్పినట్లు గుర్తు.
Tom lived in Boston when he was a child.	టామ్ చిన్నతనంలో బోస్టన్‌లో నివసించాడు.
Tom loaded the truck with sand.	టామ్ ఇసుకతో ట్రక్కును ఎక్కించాడు.
How old are you, Tom?	టామ్, మీ వయస్సు ఎంత?
We've been looking for you everywhere.	మేము ప్రతిచోటా మీ కోసం వెతుకుతున్నాము.
No one encouraged her.	ఎవరూ ఆమెను ప్రోత్సహించలేదు.
It soon began to rain very hard.	త్వరలోనే చాలా కష్టపడి వర్షం పడటం ప్రారంభమైంది.
He advised me not to believe what she says.	ఆమె చెప్పేది నమ్మవద్దని ఆయన నాకు సలహా ఇచ్చారు.
Tom is the only person who can do that, I think.	టామ్ మాత్రమే అలా చేయగలడు, నేను అనుకుంటున్నాను.
Please do something about it.	దయచేసి దాని గురించి ఏదైనా చేయండి.
That was an experience.	అది ఒక అనుభవం.
The doctor took his pulse.	డాక్టర్ అతని పల్స్ తీసుకున్నాడు.
I want you to give a message to Tom.	మీరు టామ్‌కు సందేశం ఇవ్వాలనుకుంటున్నాను.
I knew you wouldn't want to go with us.	మీరు మాతో వెళ్లాలని అనుకోరని నాకు తెలుసు.
He left his parents when he was eight years old.	అతను ఎనిమిదేళ్ళ వయసులో తల్లిదండ్రులను విడిచిపెట్టాడు.
I don't think Tom killed Mary.	టామ్ మేరీని చంపాడని నేను అనుకోను.
Tom will unlikely win today.	టామ్ ఈ రోజు గెలవలేడు.
Will anybody be at the station to meet me?	నన్ను కలవడానికి ఎవరైనా స్టేషన్‌లో ఉంటారా?
I want to make some changes.	నేను కొన్ని మార్పులు చేయాలనుకుంటున్నాను.
Do you remember what time Tom said he'd be here?	టామ్ ఇక్కడే ఉంటానని చెప్పిన సమయం మీకు గుర్తుందా?
Tom's days are numbered.	టామ్ యొక్క రోజులు లెక్కించబడ్డాయి.
I don't think that Tom was busy yesterday.	టామ్ నిన్న బిజీగా ఉన్నాడని నేను అనుకోను.
Unfortunately, that's true.	దురదృష్టవశాత్తు, అది నిజం.
What were we thinking?	మేము ఏమి ఆలోచిస్తున్నాము?
Where are you located?	మీరు ఎక్కడ ఉన్నారు?
Tom told me that he was at school.	టామ్ అతను స్కూల్లో ఉన్నానని చెప్పాడు.
Tom called me this afternoon.	టామ్ ఈ మధ్యాహ్నం నన్ను పిలిచాడు.
Try doing that again.	మళ్ళీ అలా ప్రయత్నించండి.
Tom thinks I need to help Mary.	నేను మేరీకి సహాయం చేయాల్సిన అవసరం ఉందని టామ్ భావిస్తాడు.
It was inevitable, wasn't it?	ఇది అనివార్యం, కాదా?
Tom was hoping that he could help Mary.	టామ్ మేరీకి సహాయం చేయగలడని ఆశతో ఉన్నాడు.
Tom is doing an exemplary job.	టామ్ ఒక ఆదర్శప్రాయమైన పని చేస్తున్నాడు.
I am a monk.	నేను సన్యాసిని.
Do you need it now?	మీకు ఇప్పుడు ఇది అవసరమా?
Let's do what Tom wants us to do.	టామ్ మనం ఏమి చేయాలనుకుంటున్నాడో అది చేద్దాం.
What's Tom going to say about that?	టామ్ దాని గురించి ఏమి చెప్పబోతున్నాడు?
I'll be in the basement.	నేను నేలమాళిగలో ఉంటాను.
Guntur has a rich cultural heritage and a long history dating back to the ancient times.	గుంటూరుకు గొప్ప సాంస్కృతిక వారసత్వం మరియు పురాతన కాలం నాటి సుదీర్ఘ చరిత్ర ఉంది.
Where can I exchange foreign currency?	నేను విదేశీ కరెన్సీని ఎక్కడ మార్పిడి చేసుకోగలను?
Has Tom officially retired?	టామ్ అధికారికంగా పదవీ విరమణ పొందారా?
I've heard that you shouldn't eat red meat more than once a day.	మీరు ఎర్ర మాంసం రోజుకు ఒకటి కంటే ఎక్కువసార్లు తినకూడదని విన్నాను.
Your safety isn't our concern.	మీ భద్రత మా ఆందోళన కాదు.
Tom threw Mary a life preserver.	టామ్ మేరీని లైఫ్ ప్రిజర్వర్‌గా విసిరాడు.
My father died before I got my diploma.	నా డిప్లొమా రాకముందే నాన్న చనిపోయాడు.
Tom started packing his suitcase.	టామ్ తన సూట్‌కేస్‌ను ప్యాక్ చేయడం ప్రారంభించాడు.
Tom gave a famous singer ten thousand dollars to come to the restaurant to sing Happy Birthday.	టామ్ ఒక ప్రసిద్ధ గాయకుడికి పది వేల డాలర్లు ఇచ్చి హ్యాపీ బర్త్ డే పాడటానికి రెస్టారెంట్‌కు వచ్చాడు.
Where do you plan to spend the summer?	వేసవిని ఎక్కడ గడపాలని మీరు ప్లాన్ చేస్తున్నారు?
I don't really want to think about it.	నేను నిజంగా దాని గురించి ఆలోచించడం ఇష్టం లేదు.
Native house	స్థానిక ఇల్లు
Tom said hi to me in French.	టామ్ ఫ్రెంచ్‌లో నాకు హాయ్ చెప్పాడు.
I love making desserts.	నాకు డెజర్ట్‌లు తయారు చేయడం చాలా ఇష్టం.
Tom went to a costume party last weekend.	టామ్ గత వారాంతంలో కాస్ట్యూమ్ పార్టీకి వెళ్ళాడు.
Tom and I aren't afraid.	టామ్ మరియు నేను భయపడము.
Cloudy, rainy,sunny	మేఘావృతం, వర్షం, ఎండ
Tom didn't say how he planned to get there.	టామ్ అతను అక్కడికి ఎలా వెళ్ళాలో ప్లాన్ చేయలేదు.
Tom knew I was jealous.	టామ్ నాకు అసూయ ఉందని తెలుసు.
The tea is very tasty.	టీ చాలా రుచికరమైనది.
It's doubtful that anything will grow here.	ఇక్కడ ఏదైనా పెరుగుతుందా అనేది సందేహమే.
Don't make eye contact.	కంటికి పరిచయం చేయవద్దు.
That didn't even occur to me.	అది నాకు కూడా జరగలేదు.
Krishna tells the Pandavas about the cruelty of Duryodhana.	కృష్ణుడు దుర్యోధనుడి క్రూరత్వం గురించి పాండవులకు చెప్పాడు.
Tom and Mary are both right.	టామ్ మరియు మేరీ ఇద్దరూ సరైనవారు.
Tom looks dreadful.	టామ్ భయంకరంగా కనిపిస్తాడు.
Maybe they will come and maybe they won't.	బహుశా వారు వస్తారు మరియు వారు రాకపోవచ్చు.
I love comedies.	నాకు కామెడీలు చాలా ఇష్టం.
I'm really sorry about what happened.	ఏమి జరిగిందో నేను నిజంగా క్షమించండి.
He always took a seat in the front row.	అతను ఎప్పుడూ ముందు వరుసలో ఒక సీటు తీసుకున్నాడు.
I don't think that Tom knows the rules yet.	టామ్‌కు ఇంకా నియమాలు తెలుసని నేను అనుకోను.
That's what we're waiting for.	దాని కోసం మేము ఎదురు చూస్తున్నాము.
In England, in the summer, the sun rises at about 4 a.m.	ఇంగ్లాండ్‌లో, వేసవిలో, ఉదయం 4 గంటలకు సూర్యుడు ఉదయిస్తాడు.
Both of us should lose some weight.	మా ఇద్దరికీ కొంత బరువు తగ్గాలి.
I've read every book on this shelf.	నేను ఈ షెల్ఫ్‌లోని ప్రతి పుస్తకాన్ని చదివాను.
I'm sorry, you have the wrong number.	క్షమించండి, మీకు తప్పు సంఖ్య ఉంది.
Check it again.	మళ్ళీ తనిఖీ చేయండి.
She's the French ambassador to Portugal.	ఆమె పోర్చుగల్‌లోని ఫ్రెంచ్ రాయబారి.
Clean the barrel of this rifle.	ఈ రైఫిల్ యొక్క బారెల్ శుభ్రం చేయండి.
I'm very angry now.	నాకు ఇప్పుడు చాలా కోపం ఉంది.
Tom refused to answer our questions.	టామ్ మా ప్రశ్నలకు సమాధానం ఇవ్వడానికి నిరాకరించాడు.
You're the perfect girlfriend.	నువ్వు పరిపూర్ణ స్నేహితురాలు.
Should I help Tom with his homework?	టామ్ తన ఇంటి పనికి నేను సహాయం చేయాలా?
Will you sing?	మీరు పాడతారా?
I'm not as brave as Tom.	నేను టామ్ లాగా ధైర్యంగా లేను.
It took me several hours to paint that room.	ఆ గదిని చిత్రించడానికి నాకు చాలా గంటలు పట్టింది.
Tom pocketed the money.	టామ్ డబ్బు జేబులో పెట్టుకున్నాడు.
Nobody's going anywhere.	ఎవరూ ఎక్కడికి వెళ్ళడం లేదు.
How could I've let that happen?	నేను దానిని ఎలా చేయగలను?
please excuse me	దయచేసి నన్ను క్షేమించండి
Swami Vivekananda was a disciple of the great Indian saint.	స్వామి వివేకానంద గొప్ప భారతీయ సాధువు శిష్యుడు.
I'm sorry, but could you move over a bit so I have room to sit?	నన్ను క్షమించండి, కానీ మీరు కూర్చోవడానికి స్థలం ఉన్నందున మీరు కొంచెం ముందుకు వెళ్ళగలరా?
Tom did what he promised he'd do.	టామ్ తాను చేస్తానని వాగ్దానం చేసినట్లు చేశాడు.
I don't think Tom is coming to our rescue.	టామ్ మా రక్షణకు వస్తున్నాడని నేను అనుకోను.
I know you're afraid of heights.	మీరు ఎత్తులకు భయపడుతున్నారని నాకు తెలుసు.
The dining room has two doors.	భోజనాల గదికి రెండు తలుపులు ఉన్నాయి.
My house is on the outskirts of town.	నా ఇల్లు పట్టణ శివార్లలో ఉంది.
K. S. Chitra has won numerous awards for her contribution to music including six National Film Awards, five Filmfare Awards South, and several state government awards.	K. S. చిత్ర ఆరు జాతీయ చలనచిత్ర అవార్డులు, ఐదు ఫిల్మ్‌ఫేర్ అవార్డులు సౌత్ మరియు అనేక రాష్ట్ర ప్రభుత్వ అవార్డులతో సహా సంగీతానికి ఆమె చేసిన కృషికి అనేక అవార్డులను గెలుచుకుంది.
I must buy a new pair of shoes.	నేను తప్పనిసరిగా కొత్త జత బూట్లు కొనాలి.
How often do you take a shower?	మీరు ఎంత తరచుగా స్నానం చేస్తారు?
Many men want to be thin, too.	చాలా మంది పురుషులు కూడా సన్నగా ఉండాలని కోరుకుంటారు.
Did they ever find Tom?	వారు ఎప్పుడైనా టామ్‌ను కనుగొన్నారా?
He has a Toyota.	అతనికి టయోటా ఉంది.
She was asked not to speak at the meeting.	సమావేశంలో మాట్లాడవద్దని ఆమెను కోరారు.
I believe you all know Tom.	మీ అందరికీ టామ్ తెలుసని నేను నమ్ముతున్నాను.
We must stop Tom before he kills himself.	టామ్ తనను తాను చంపేముందు మనం అతన్ని ఆపాలి.
I want another beer.	నాకు మరో బీర్ కావాలి.
I want to apologize for everything I said.	నేను చెప్పిన ప్రతిదానికీ క్షమాపణ చెప్పాలనుకుంటున్నాను.
There are some differences.	కొన్ని తేడాలు ఉన్నాయి.
They might not notice that Tom isn't here.	టామ్ ఇక్కడ లేడని వారు గమనించకపోవచ్చు.
The new telescope was shipped in a huge wooden box.	కొత్త టెలిస్కోప్ భారీ చెక్క పెట్టెలో రవాణా చేయబడింది.
Tom said that he felt cold.	టామ్ తనకు చలిగా అనిపించింది.
Tom was obviously scared.	టామ్ స్పష్టంగా భయపడ్డాడు.
It must've been terrible.	ఇది భయంకరమైనది.
I want to come back next year.	నేను వచ్చే ఏడాది తిరిగి రావాలనుకుంటున్నాను.
Mary is a brave woman.	మేరీ ధైర్యవంతురాలు.
The sky was gray all morning.	ఉదయం అంతా ఆకాశం బూడిద రంగులో ఉంది.
I never liked Christmas.	నేను క్రిస్మస్‌ను ఎప్పుడూ ఇష్టపడలేదు.
I'm considering becoming a French teacher.	నేను ఫ్రెంచ్ ఉపాధ్యాయుడిగా మారాలని ఆలోచిస్తున్నాను.
I didn't know you'd be jealous.	మీరు అసూయపడతారని నాకు తెలియదు.
Tom told me the book was interesting.	టామ్ పుస్తకం ఆసక్తికరంగా ఉందని నాకు చెప్పారు.
Is it cheaper to call after nine?	తొమ్మిది తర్వాత కాల్ చేయడం చౌకైనదా?
Tom buys me things that I want.	టామ్ నాకు కావలసిన వస్తువులను కొంటాడు.
Where can I advertise for a used car?	ఉపయోగించిన కారు కోసం నేను ఎక్కడ ప్రకటన చేయవచ్చు?
The couple broke off their engagement.	ఈ జంట వారి నిశ్చితార్థాన్ని విరమించుకున్నారు.
I want to date other women.	నేను ఇతర మహిళలతో డేటింగ్ చేయాలనుకుంటున్నాను.
Tom says he was fired.	టామ్ తనను తొలగించారని చెప్పారు.
She was in the hospital for six weeks because she was sick.	ఆమె అనారోగ్యంతో ఆరు వారాలపాటు ఆసుపత్రిలో ఉంది.
Please inform me of any change in his condition.	దయచేసి అతని స్థితిలో ఏదైనా మార్పు గురించి నాకు తెలియజేయండి.
Tom is signing documents.	టామ్ పత్రాలపై సంతకం చేస్తున్నాడు.
I'm sure of this.	నేను ఈ విషయంలో ఖచ్చితంగా ఉన్నాను.
Tom and Mary wanted to be together.	టామ్ మరియు మేరీ కలిసి ఉండాలని కోరుకున్నారు.
Both boys and girls should take cooking class in school.	బాలురు మరియు బాలికలు ఇద్దరూ పాఠశాలలో వంట తరగతి తీసుకోవాలి.
Where's it used?	ఇది ఎక్కడ ఉపయోగించబడింది?
Tom sells cars.	టామ్ కార్లను విక్రయిస్తాడు.
The automobile stopped.	ఆటోమొబైల్ ఆగిపోయింది.
playing with fire	నిప్పుతో ఆడుకుంటున్నాడు
My watch loses three minutes a week.	నా గడియారం వారానికి మూడు నిమిషాలు కోల్పోతుంది.
Let us tell you why we came.	మేము ఎందుకు వచ్చామో మీకు చెప్తాము.
I'll tell you everything that you want to know.	మీరు తెలుసుకోవాలనుకునే ప్రతిదీ మీకు చెప్తాను.
Sunil loves his mother.	సునీల్ తన తల్లిని ప్రేమిస్తాడు.
She wanted him to say that he loved her.	అతను తనను ప్రేమిస్తున్నాడని అతను చెప్పాలని ఆమె కోరుకుంది.
She's busy.	ఆమె బిజీగా ఉంది.
I strongly suspected that he had been lying.	అతను అబద్ధం చెప్పాడని నేను గట్టిగా అనుమానించాను.
Don't tell my wife that.	నా భార్యకు అలా చెప్పకండి.
She is anxious about your health.	ఆమె మీ ఆరోగ్యం గురించి ఆత్రుతగా ఉంది.
Tom sometimes agrees with me.	టామ్ కొన్నిసార్లు నాతో అంగీకరిస్తాడు.
Have you ever climbed Mt. Fuji?	మీరు ఎప్పుడైనా మౌంట్ ఎక్కారా?
Tom thought that Mary was John's sister.	టామ్ మేరీ జాన్ సోదరి అని అనుకున్నాడు.
I've learned so much from you.	నేను మీ నుండి చాలా నేర్చుకున్నాను.
It's time to get up.	ఇది లేవడానికి సమయం.
Both Tom and I'll be busy this afternoon.	టామ్ మరియు నేను ఇద్దరూ ఈ మధ్యాహ్నం బిజీగా ఉంటాము.
You can hear English on Channel 1, and Japanese on Channel 7.	మీరు ఛానల్ 1 లో ఇంగ్లీష్ మరియు ఛానల్ 7 లో జపనీస్ వినవచ్చు.
These are the new ones.	ఇవి కొత్తవి.
I'm looking for a job.	నేను ఉద్యోగం కోసం చూస్తున్నాను.
Tom told us he loved skiing.	టామ్ మాకు స్కీయింగ్ అంటే చాలా ఇష్టమని చెప్పాడు.
That's his weak spot.	అది అతని బలహీనమైన ప్రదేశం.
Do you have blankets?	మీకు దుప్పట్లు ఉన్నాయా?
Tom can't whistle.	టామ్ ఈల వేయలేడు.
Nobody said a thing.	ఎవరూ ఏమీ అనలేదు.
How's your day going?	నీ రోజు ఎలా గడుస్తోంది?
Tom couldn't believe that someone wanted to kill him.	ఎవరైనా తనను చంపాలని కోరుకుంటున్నారని టామ్ నమ్మలేకపోయాడు.
I have terrible handwriting.	నాకు భయంకరమైన చేతివ్రాత ఉంది.
I know you hate it.	మీరు దానిని ద్వేషిస్తున్నారని నాకు తెలుసు.
Put it on my tab.	నా ట్యాబ్‌లో ఉంచండి.
Where did you get your camera repaired?	మీ కెమెరా మరమ్మతులు ఎక్కడ పొందారు?
Are you saying this doesn't matter?	ఇది పట్టింపు లేదని మీరు చెబుతున్నారా?
She is from Hokkaido, but is now living in Tokyo.	ఆమె హక్కైడోకు చెందినది, కానీ ఇప్పుడు టోక్యోలో నివసిస్తోంది.
How can I learn Telugu?	నేను తెలుగు ఎలా నేర్చుకోవాలి?
You've got to apologize.	మీరు క్షమాపణ చెప్పాలి.
Shall we take a taxi?	మనం టాక్సీ తీసుకుందా?
start	ప్రారంభించు
How will that decision affect us?	ఆ నిర్ణయం మనల్ని ఎలా ప్రభావితం చేస్తుంది?
I know what I want.	నాకు ఏమి కావాలో నాకు తెలుసు.
I expect a detailed report.	నేను ఒక వివరణాత్మక నివేదికను ఆశిస్తున్నాను.
The sea gulls are flying low.	సముద్రపు గల్లాలు తక్కువగా ఎగురుతున్నాయి.
Gangadhar lives with his family.	గంగాధర్ కుటుంబంతో కలిసి ఉంటున్నాడు.
You did your job well.	మీరు మీ పని బాగా చేసారు.
We took him to the hospital.	మేము అతన్ని ఆసుపత్రికి తీసుకువెళ్ళాము.
I can't even remember what Tom looks like.	టామ్ ఎలా ఉంటాడో నాకు గుర్తులేదు.
Tom told me I was mistaken.	టామ్ నాకు పొరపాటు అని చెప్పాడు.
I made tea for Tom.	నేను టామ్ కోసం టీ తయారు చేసాను.
Tom told me I shouldn't talk to you.	నేను మీతో మాట్లాడకూడదని టామ్ చెప్పాడు.
The teacher wrote French words on the blackboard.	గురువు నల్లబల్లపై ఫ్రెంచ్ పదాలు రాశారు.
Is your mother at home now?	మీ తల్లి ఇప్పుడు ఇంట్లో ఉందా?
They're all equal.	వారంతా సమానం.
Who taught Tom how to speak French?	టామ్ ఫ్రెంచ్ మాట్లాడటం ఎలా నేర్పించారు?
Tom and Mary believed John.	టామ్ మరియు మేరీ జాన్‌ను నమ్మారు.
Tom is the only person Mary says she can trust.	మేరీ తనను నమ్మగలదని చెప్పే ఏకైక వ్యక్తి టామ్.
It isn't big.	ఇది పెద్దది కాదు.
I'm not going to tell Tom anything.	నేను టామ్‌కు ఏమీ చెప్పను.
Put out your cigarettes.	మీ సిగరెట్లు బయట పెట్టండి.
Is Tom smarter than you?	టామ్ మీ కంటే తెలివిగా ఉన్నారా?
OK, I think we can begin.	సరే, మనం ప్రారంభించవచ్చని అనుకుంటున్నాను.
Did Tom tell you he's studying French?	టామ్ అతను ఫ్రెంచ్ చదువుతున్నాడని మీకు చెప్పాడా?
Can you tell us what it is?	అది ఏమిటో మాకు చెప్పగలరా?
Washington was the most famous man in America.	వాషింగ్టన్ అమెరికాలో అత్యంత ప్రసిద్ధ వ్యక్తి.
We're not worried about that at all.	మేము దాని గురించి ఆందోళన చెందలేదు.
All you have to do is fill in this form.	మీరు చేయాల్సిందల్లా ఈ ఫారమ్ నింపండి.
We'll stay and fight.	మేము ఉండి పోరాడతాము.
What do I have to say to convince you?	మిమ్మల్ని ఒప్పించటానికి నేను ఏమి చెప్పాలి?
You always talk back to me, don't you?	మీరు ఎల్లప్పుడూ నాతో తిరిగి మాట్లాడతారు, లేదా?
Tom swore he wouldn't do that.	టామ్ తాను అలా చేయనని ప్రమాణం చేశాడు.
I'm trying to stay calm.	నేను ప్రశాంతంగా ఉండటానికి ప్రయత్నిస్తున్నాను.
I had lunch with Tom today.	నేను ఈ రోజు టామ్‌తో కలిసి భోజనం చేశాను.
Are you sleepy?	నిద్రోస్తుందా?
Both of my brothers are married.	నా సోదరులు ఇద్దరూ వివాహం చేసుకున్నారు.
Their house is near here.	వారి ఇల్లు ఇక్కడ ఉంది.
Tell Tom that I'll prune his trees for him.	టామ్ కి చెప్పండి నేను అతని చెట్లను కత్తిరించుకుంటాను.
I've never been to Australia.	నేను ఎప్పుడూ ఆస్ట్రేలియాకు వెళ్ళలేదు.
I don't have a lot of patients.	నాకు చాలా మంది రోగులు లేరు.
Our next meeting will be held next on October 20th.	మా తదుపరి సమావేశం అక్టోబర్ 20 న జరుగుతుంది.
Tom had a narrow escape from death.	టామ్ మరణం నుండి ఇరుకైన తప్పించుకున్నాడు.
Carry on with your work.	మీ పనిని కొనసాగించండి.
Tom popped into the supermarket on his way home to buy some milk.	టామ్ కొంచెం పాలు కొనడానికి ఇంటికి వెళ్ళేటప్పుడు సూపర్ మార్కెట్లోకి ప్రవేశించాడు.
I don't think they're safe.	వారు సురక్షితంగా ఉన్నారని నేను అనుకోను.
She wrapped her arms around his neck.	ఆమె అతని చేతులను అతని మెడలో చుట్టింది.
hungry	ఆకలి
I can't find Tom anywhere.	నేను టామ్‌ను ఎక్కడా కనుగొనలేను.
Mary is a pretty girl, isn't she?	మేరీ ఒక అందమైన అమ్మాయి, ఆమె కాదా?
rich	ధనవంతుడు
You can't be so sure.	మీరు అంత ఖచ్చితంగా ఉండలేరు.
We have a complete set of the recordings of Beethoven's symphonies.	బీతొవెన్ యొక్క సింఫొనీల రికార్డింగ్‌ల పూర్తి సెట్ మాకు ఉంది.
Summer has just begun.	వేసవి ఇప్పుడే ప్రారంభమైంది.
I'm glad to hear you're better.	మీరు బాగున్నారని వినడానికి నేను సంతోషిస్తున్నాను.
I'd like to introduce Tom to Mary.	నేను టామ్‌ను మేరీకి పరిచయం చేయాలనుకుంటున్నాను.
Tom is loyal to his wife.	టామ్ తన భార్యకు విధేయుడు.
I didn't receive any notice.	నాకు నోటీసు రాలేదు.
School was cancelled because of the snow.	మంచు కారణంగా పాఠశాల రద్దు చేయబడింది.
Almost no one thinks that we are sisters.	మేము సోదరీమణులు అని దాదాపు ఎవరూ అనుకోరు.
They don't understand me when I speak German.	నేను జర్మన్ మాట్లాడేటప్పుడు వారు నన్ను అర్థం చేసుకోరు.
Tom tricked Mary into paying for his ticket.	టామ్ తన టికెట్ కోసం మేరీని మోసగించాడు.
Where did you get all this stuff?	ఈ విషయాలన్నీ మీకు ఎక్కడ లభించాయి?
Can you translate this manuscript from French to English?	మీరు ఈ మాన్యుస్క్రిప్ట్‌ను ఫ్రెంచ్ నుండి ఇంగ్లీషులోకి అనువదించగలరా?
Tom flew to Boston today.	టామ్ ఈ రోజు బోస్టన్‌కు వెళ్లాడు.
great movie	గొప్ప సినిమా
Tom has a kind heart.	టామ్ దయగల హృదయాన్ని కలిగి ఉన్నాడు.
They'll do what I tell them to do.	నేను చేయమని చెప్పినట్లు వారు చేస్తారు.
Tom didn't seem happy to see me.	టామ్ నన్ను చూడటం సంతోషంగా అనిపించలేదు.
Come here.	ఇక్కడికి రండి.
Tom and Mary are close relatives.	టామ్ మరియు మేరీ దగ్గరి బంధువులు.
Tom wants Mary and I to do that by ourselves.	టామ్ మేరీ మరియు నేను మనమే చేయాలని కోరుకుంటున్నాను.
I found out something interesting today.	నేను ఈ రోజు ఆసక్తికరమైన విషయం కనుగొన్నాను.
Tom plays the piano very well.	టామ్ పియానోను బాగా వాయించాడు.
Tom isn't used to city life.	టామ్ నగర జీవితానికి అలవాటుపడలేదు.
We were kids together.	మేము కలిసి పిల్లలు.
Tom is a much better singer than I am.	టామ్ నాకన్నా మంచి గాయకుడు.
don't manipulate me	నన్ను తారుమారు చేయవద్దు
Tom switched off the dryer.	టామ్ డ్రైయర్‌ను స్విచ్ ఆఫ్ చేశాడు.
You two may leave.	మీరిద్దరూ వెళ్ళవచ్చు.
Tom said he couldn't walk.	టామ్ తాను నడవలేనని చెప్పాడు.
What would you do in my position?	నా స్థానంలో మీరు ఏమి చేస్తారు?
You're welcome to any book in my library.	నా లైబ్రరీలోని ఏదైనా పుస్తకానికి మీకు స్వాగతం.
Sanskrit is an ancient language that originated in the Indian subcontinent.	సంస్కృతం భారతీయ ఉపఖండంలో ఉద్భవించిన ప్రాచీన భాష.
They sat down.	వారు కూర్చున్నారు.
Is your car black?	మీ కారు నల్లగా ఉందా?
Tom is thirteen, but he still believes in Santa.	టామ్ పదమూడు సంవత్సరాలు, కానీ అతను ఇప్పటికీ శాంటాను నమ్ముతాడు.
We think you're right.	మీరు సరైనవారని మేము భావిస్తున్నాము.
They were silent.	వారు మౌనంగా ఉన్నారు.
ourself	మనమే
Do you think Tom saw it?	టామ్ చూశానని మీరు అనుకుంటున్నారా?
This dish is too spicy.	ఈ వంటకం చాలా కారంగా ఉంటుంది.
quickly	త్వరగా
Can you imagine what life would be like without television?	టెలివిజన్ లేకుండా జీవితం ఎలా ఉంటుందో మీరు Can హించగలరా?
Cricket player from Chennai	చెన్నైకి చెందిన క్రికెట్ ప్లేయర్
Tom put the kids to bed.	టామ్ పిల్లలను మంచానికి పెట్టాడు.
I don't have a Twitter account.	నాకు ట్విట్టర్ ఖాతా లేదు.
Tom asked Mary some stupid questions that she refused to answer.	టామ్ మేరీకి కొన్ని తెలివితక్కువ ప్రశ్నలను అడిగారు.
forgot	మర్చిపోయాను
A temple is a building reserved for spiritual rituals and activities such as prayer and sacrifice.	దేవాలయం అనేది ఆధ్యాత్మిక ఆచారాలు మరియు ప్రార్థన మరియు త్యాగం వంటి కార్యకలాపాల కోసం ప్రత్యేకించబడిన భవనం.
He was not about to admit his mistake.	అతను తన తప్పును అంగీకరించడం లేదు.
slowly	నెమ్మదిగా
You know I love you!	నేను నిన్ను ప్రేమిస్తున్నానని నీకు తెలుసు!
You probably just have a cold.	మీకు జలుబు ఉండవచ్చు.
Why do you think Tom wanted me to do that?	టామ్ నన్ను అలా చేయాలని ఎందుకు అనుకున్నాడు?
What does this machine do exactly?	ఈ యంత్రం సరిగ్గా ఏమి చేస్తుంది?
Father	తండ్రి
I've got a pain in my side.	నా వైపు నొప్పి వచ్చింది.
Tom put his shirt on a hanger.	టామ్ తన చొక్కాను హ్యాంగర్ మీద ఉంచాడు.
Tom didn't need to wait.	టామ్ వేచి ఉండాల్సిన అవసరం లేదు.
Maybe I shouldn't have done that.	బహుశా నేను అలా చేయకూడదు.
My aunt had three kids.	నా అత్తకు ముగ్గురు పిల్లలు ఉన్నారు.
Tom didn't notice the change.	టామ్ మార్పును గమనించలేదు.
I got a smooth shave.	నాకు మృదువైన గొరుగుట వచ్చింది.
I see life differently now.	నేను ఇప్పుడు జీవితాన్ని భిన్నంగా చూస్తున్నాను.
He feels very happy.	అతను చాలా సంతోషంగా ఉన్నాడు.
If Tom wasn't so stupid, he would've understood quicker.	టామ్ అంత తెలివితక్కువవాడు కాకపోతే, అతను త్వరగా అర్థం చేసుకున్నాడు.
I use Google almost every day.	నేను దాదాపు ప్రతిరోజూ గూగుల్‌ని ఉపయోగిస్తాను.
Tom said that he needed a rest.	తనకు విశ్రాంతి అవసరమని టామ్ చెప్పాడు.
The police can't stop this.	పోలీసులు దీనిని ఆపలేరు.
This box is empty. It has nothing in it.	ఈ పెట్టె ఖాళీగా ఉంది.
I'll dream about you.	నేను మీ గురించి కలలు కంటున్నాను.
I hope you and Tom will have a good time.	మీకు మరియు టామ్‌కు మంచి సమయం లభిస్తుందని నేను ఆశిస్తున్నాను.
Is it true that Tom can't see very well out of his left eye?	టామ్ తన ఎడమ కన్ను నుండి బాగా చూడలేడు అనేది నిజమేనా?
Shadow him.	అతనికి నీడ.
I don't support his ideas.	నేను అతని ఆలోచనలకు మద్దతు ఇవ్వను.
I've been to the dentist's.	నేను దంతవైద్యుని వద్దకు వెళ్లాను.
Everything	అంతా(ప్రతిదీ)
I am very happy to meet you	మిమ్మల్ని కలవడం నాకు చాలా సంతోషంగా ఉంది
We should wait for Tom.	మేము టామ్ కోసం వేచి ఉండాలి.
Tom swam with the dolphins.	టామ్ డాల్ఫిన్లతో ఈదుకున్నాడు.
Tom's unstoppable.	టామ్ యొక్క ఆపుకోలేనిది.
Where	ఎక్కడ
Look what you've done to me.	మీరు నాకు ఏమి చేశారో చూడండి.
I just don't think I'm successful enough.	నేను తగినంత విజయవంతమయ్యానని నేను అనుకోను.
Tom told Mary to tell the truth.	టామ్ మేరీకి నిజం చెప్పమని చెప్పాడు.
I've been looking for Tom.	నేను టామ్ కోసం చూస్తున్నాను.
Tom cut his sister a piece of cake.	టామ్ తన సోదరికి కేక్ ముక్కను కత్తిరించాడు.
I respect you for what you have done.	మీరు చేసిన పనికి నేను నిన్ను గౌరవిస్తాను.
Going to Nellore to Vellore.	నెల్లూరు నుంచి వేలూరు వెళ్తున్నారు.
Tom isn't having fun.	టామ్ సరదాగా లేడు.
I'm not strong enough to do that.	నేను అలా చేయటానికి బలంగా లేను.
I think I speak French about as well as Tom does.	నేను టామ్ గురించి ఫ్రెంచ్ మాట్లాడతాను.
Choose one.	ఒకటి ఎంచుకోండి.
Tom speaks French better than Mary does.	టామ్ మేరీ కంటే ఫ్రెంచ్ బాగా మాట్లాడతాడు.
I don't think I impressed Tom.	నేను టామ్‌ను ఆకట్టుకున్నాను.
I saw Tom sitting at the bar alone, drinking wine.	టామ్ ఒంటరిగా బార్ వద్ద కూర్చుని, వైన్ తాగడం చూశాను.
You're avoiding me.	మీరు నన్ను తప్పించుకుంటున్నారు.
Does Tom really have a girlfriend?	టామ్‌కు నిజంగా స్నేహితురాలు ఉందా?
I'd forgotten about that.	నేను దాని గురించి మరచిపోయాను.
If the weather is nice tomorrow, we will have a picnic.	రేపు వాతావరణం బాగుంటే, మాకు పిక్నిక్ ఉంటుంది.
I won't always be around.	నేను ఎప్పుడూ చుట్టూ ఉండను.
It had to be you.	ఇది మీరు అయి ఉండాలి.
I'm wasting my time.	నేను నా సమయాన్ని వృధా చేస్తున్నాను.
I slept only two hours.	నేను రెండు గంటలు మాత్రమే పడుకున్నాను.
Mother	అమ్మా
He put salt into his cup of coffee by mistake.	అతను పొరపాటున తన కప్పు కాఫీలో ఉప్పు వేశాడు.
We all want to be liked.	మనమందరం ఇష్టపడాలని కోరుకుంటున్నాము.
Tom's wicked.	టామ్ యొక్క దుష్ట.
Tom was the one who got punished.	శిక్ష అనుభవించిన వ్యక్తి టామ్.
Where is your brother?	మీ సోదరుడు ఎక్కడ?
Have you spent a lot of time with Tom?	మీరు టామ్‌తో చాలా సమయం గడిపారు?
I forgot my password.	నేను నా పాస్వర్డ్ను మర్చిపోయాను.
I am coming from Ahmedabad	నేను అహ్మదాబాద్ నుండి వస్తున్నాను
It's too painful.	ఇది చాలా బాధాకరమైనది.
Why don't we have dinner?	మనకు ఎందుకు విందు లేదు?
Native place	స్వస్థలము
Tom has been managing just fine.	టామ్ బాగానే ఉన్నాడు.
I can't let you do this.	నేను దీన్ని మీకు అనుమతించలేను.
Mom did not mention it.	అమ్మ దాని గురించి ప్రస్తావించలేదు.
Could you show me this bag?	మీరు ఈ బ్యాగ్ నాకు చూపించగలరా?
I see someone waving a white flag.	ఎవరో తెల్ల జెండా aving పుతూ నేను చూస్తున్నాను.
What do you call this animal in French?	మీరు ఈ జంతువును ఫ్రెంచ్ భాషలో ఏమని పిలుస్తారు?
Tom wanted to quit smoking.	టామ్ ధూమపానం మానేయాలని అనుకున్నాడు.
Brother	సోదరుడు
Tom said he'll wait.	టామ్ అతను వేచి ఉంటానని చెప్పాడు.
You must get rid of such a habit.	మీరు అలాంటి అలవాటును వదిలించుకోవాలి.
We stayed behind to help Tom.	టామ్‌కు సహాయం చేయడానికి మేము వెనుక ఉండిపోయాము.
Chatrapati shivaji one of the most powerful empires in India during the 17th and 18th centuries.	చత్రపతి శివాజీ 17వ మరియు 18వ శతాబ్దాలలో భారతదేశంలోని అత్యంత శక్తివంతమైన సామ్రాజ్యాలలో ఒకటి.
Mary demanded her money back.	మేరీ తన డబ్బును తిరిగి డిమాండ్ చేసింది.
He lost his temper and shouted at me.	అతను నిగ్రహాన్ని కోల్పోయాడు మరియు నాపై అరిచాడు.
I don't feel like working today.	ఈ రోజు పని చేయాలని నాకు అనిపించదు.
Tom can't help us today.	టామ్ ఈ రోజు మాకు సహాయం చేయలేడు.
Tom said that he had been busy.	టామ్ తాను బిజీగా ఉన్నానని చెప్పాడు.
I'm getting bored.	నేను విసుగు చెందుతున్నాను.
Tom asked us not to make any noise.	టామ్ మాకు శబ్దం చేయవద్దని కోరాడు.
I've always known that this would happen someday.	ఇది ఏదో ఒక రోజు జరుగుతుందని నాకు తెలుసు.
The first girl I ever kissed was Mary.	నేను ముద్దు పెట్టుకున్న మొదటి అమ్మాయి మేరీ.
I still love you very much.	నేను ఇప్పటికీ నిన్ను చాలా ప్రేమిస్తున్నాను.
I wish I were rich.	నేను ధనవంతుడిని అని కోరుకుంటున్నాను.
Tom doesn't feel like doing that now.	టామ్ ఇప్పుడు అలా చేస్తున్నట్లు అనిపించదు.
Telugu to hindi translation	తెలుగు నుండి హిందీకి అనువాదం
How many times did you visit your grandparents last year?	గత సంవత్సరం మీరు మీ తాతామామలను ఎన్నిసార్లు సందర్శించారు?
It's not serious.	ఇది తీవ్రంగా లేదు.
Thousands of homes were destroyed.	వేలాది గృహాలు ధ్వంసమయ్యాయి.
I forgot to lock the front door.	నేను ముందు తలుపు లాక్ చేయడం మర్చిపోయాను.
A mile is about 1,600 meters.	ఒక మైలు 1,600 మీటర్లు.
Don't dress like a tourist.	పర్యాటకుడిలా దుస్తులు ధరించవద్దు.
How do you like that?	మీకు అది ఎలా ఇష్టం?
They arrived at the hotel.	వారు హోటల్ వద్దకు వచ్చారు.
Why don't you leave, Tom?	టామ్, మీరు ఎందుకు వెళ్లరు?
Hopefully, we'll see Tom today.	ఆశాజనక, మేము ఈ రోజు టామ్‌ను చూస్తాము.
Tom has a secret room in his house.	టామ్ తన ఇంట్లో ఒక రహస్య గది ఉంది.
These aren't yours, are they?	ఇవి మీవి కాదా?
Some boys came into the classroom.	కొంతమంది కుర్రాళ్ళు తరగతి గదిలోకి వచ్చారు.
Tom was defeated.	టామ్ ఓడిపోయాడు.
Lata Mangeshkar is a legendary Indian playback singer who has sung in over a thousand Hindi films, as well as in various other Indian and foreign languages.	లతా మంగేష్కర్ ఒక పురాణ భారతీయ నేపథ్య గాయని, ఆమె వెయ్యికి పైగా హిందీ చిత్రాలలో, అలాగే అనేక ఇతర భారతీయ మరియు విదేశీ భాషలలో పాడింది.
Everybody jumped into the pool.	అందరూ కొలనులోకి దూకేశారు.
Sai is feeling good	సాయికి మంచి అనుభూతి కలుగుతోంది
How do you feel now?	ఇప్పుడు మీకు ఎలా అనిపిస్తుంది?
Tom is the first guy Mary has really been interested in since she broke up with John.	జాన్ జాన్‌తో విడిపోయినప్పటి నుండి మేరీకి నిజంగా ఆసక్తి ఉన్న మొదటి వ్యక్తి టామ్.
Tom isn't a student.	టామ్ విద్యార్థి కాదు.
Tom doesn't know how sick Mary is.	మేరీ ఎంత అనారోగ్యంతో ఉన్నారో టామ్‌కు తెలియదు.
Don't talk with your mouth full.	మీ నోటితో పూర్తిగా మాట్లాడకండి.
I want to wash my hair.	నేను నా జుట్టు కడగాలి.
Bring me the newspaper.	నాకు వార్తాపత్రిక తీసుకురండి.
Directions	దిశలు
The result will satisfy him.	ఫలితం అతన్ని సంతృప్తిపరుస్తుంది.
You're turning red.	మీరు ఎరుపు రంగులోకి మారుతున్నారు.
S. P. Balasubrahmanyam, was a legendary Indian playback singer and music composer who primarily worked in the Tamil, Telugu, Kannada, Hindi, and Malayalam film industries.	S. P. బాలసుబ్రహ్మణ్యం, ప్రముఖ భారతీయ నేపథ్య గాయకుడు మరియు సంగీత స్వరకర్త, అతను ప్రధానంగా తమిళం, తెలుగు, కన్నడ, హిందీ మరియు మలయాళ చిత్ర పరిశ్రమలలో పనిచేశాడు.
name	పేరు
I couldn't eat fish when I was a child.	నేను చిన్నతనంలో చేపలు తినలేను.
Odd, isn't it? We should have already arrived.	బేసి, కాదా?
No one's hungry.	ఎవరికీ ఆకలి లేదు.
Who is your favorite pianist?	మీకు ఇష్టమైన పియానిస్ట్ ఎవరు?
Didn't you know that Tom and I needed to do that?	టామ్ మరియు నేను అలా చేయాల్సిన అవసరం ఉందని మీకు తెలియదా?
It's likely a mistake.	ఇది పొరపాటు.
How many people are on board the ship?	ఓడలో ఎంత మంది ఉన్నారు?
She's thirty-three.	ఆమె ముప్పై మూడు.
There are three printing presses in the workshop.	వర్క్‌షాప్‌లో మూడు ప్రింటింగ్ ప్రెస్‌లు ఉన్నాయి.
Do you know anybody who speaks five languages?	ఐదు భాషలు మాట్లాడే ఎవరైనా మీకు తెలుసా?
Please don't tell anyone I did that.	నేను అలా చేశానని ఎవరికీ చెప్పవద్దు.
I sat down next to him.	నేను అతని పక్కన కూర్చున్నాను.
end	ముగింపు
Nellore has a rich history and cultural heritage, with several historical landmarks and temples that attract tourists from all over the world.	నెల్లూరుకు గొప్ప చరిత్ర మరియు సాంస్కృతిక వారసత్వం ఉంది, అనేక చారిత్రక ప్రదేశాలు మరియు దేవాలయాలు ప్రపంచం నలుమూలల నుండి పర్యాటకులను ఆకర్షిస్తాయి.
Tom isn't my uncle.	టామ్ నా మామయ్య కాదు.
I'm in the eleventh grade.	నేను పదకొండవ తరగతిలో ఉన్నాను.
The computer is broken.	కంప్యూటర్ విరిగిపోయింది.
I didn't get the joke.	నాకు జోక్ రాలేదు.
I didn't swim because it was too cold.	చాలా చల్లగా ఉన్నందున నేను ఈత కొట్టలేదు.
I don't think I've ever been this happy.	నేను ఇంత సంతోషంగా ఉన్నానని నేను అనుకోను.
sports	క్రీడలు
I think you know what I'm talking about.	నేను ఏమి మాట్లాడుతున్నానో మీకు తెలుసని అనుకుంటున్నాను.
Tom is wearing an expensive suit.	టామ్ ఖరీదైన సూట్ ధరించి ఉన్నాడు.
The city has a railway station that is part of the South Central Railway network.	నగరంలో దక్షిణ మధ్య రైల్వే నెట్‌వర్క్‌లో భాగమైన రైల్వే స్టేషన్ ఉంది.
Tom and I both live and work in Australia.	టామ్ మరియు నేను ఇద్దరూ ఆస్ట్రేలియాలో నివసిస్తున్నాము మరియు పని చేస్తున్నాము.
The door must not be left open.	తలుపు తెరిచి ఉంచకూడదు.
Tom is our foster son.	టామ్ మా పెంపుడు కొడుకు.
I haven't talked to Tom in a very long time.	నేను టామ్‌తో చాలా కాలం మాట్లాడలేదు.
Tom is 13, but he still believes in Santa.	టామ్ వయసు 13, కానీ అతను ఇప్పటికీ శాంటాను నమ్ముతాడు.
Has Tom cleaned his room yet?	టామ్ తన గదిని ఇంకా శుభ్రం చేశాడా?
I warned Tom not to come here.	టామ్‌ను ఇక్కడికి రానివ్వమని హెచ్చరించాను.
The temple is one of the oldest and most prominent temples in Nellore.	ఈ ఆలయం నెల్లూరులోని పురాతన మరియు ప్రముఖ దేవాలయాలలో ఒకటి.
I don't like being treated like a child.	నేను చిన్నపిల్లలా వ్యవహరించడం ఇష్టం లేదు.
Was that Tom you were just talking to?	ఆ టామ్ మీరు ఇప్పుడే మాట్లాడుతున్నారా?
I'm very glad that I didn't do that.	నేను అలా చేయనందుకు చాలా సంతోషంగా ఉంది.
I suppose you'll be studying all day tomorrow.	మీరు రేపు రోజంతా చదువుతారని అనుకుందాం.
I was really depressed.	నేను నిజంగా నిరాశకు గురయ్యాను.
i am going to sleep	నేను నిద్రించటానికి వెళుతున్నాను
Tom married a girl much younger than himself.	టామ్ తనకన్నా చాలా చిన్న అమ్మాయిని వివాహం చేసుకున్నాడు.
Tom cut off Mary's head.	టామ్ మేరీ తల కత్తిరించాడు.
Do you have a piano?	మీకు పియానో ఉందా?
I'm not going to sing.	నేను పాడటానికి వెళ్ళడం లేదు.
I have an excuse.	నాకు ఒక అవసరం లేదు.
The police went over every inch of this place.	పోలీసులు ఈ స్థలం యొక్క ప్రతి అంగుళం మీదుగా వెళ్లారు.
The waiter came over to take away Tom's empty plate.	టామ్ యొక్క ఖాళీ ప్లేట్ తీసివేయడానికి వెయిటర్ వచ్చాడు.
Here are your wages for the last month.	గత నెలలో మీ వేతనాలు ఇక్కడ ఉన్నాయి.
I ran to school.	నేను బడికి పరిగెత్తాను.
I admit, I'm not the tidiest person in the world.	నేను అంగీకరిస్తున్నాను, నేను ప్రపంచంలో చక్కని వ్యక్తిని కాదు.
We know what to expect.	ఏమి ఆశించాలో మాకు తెలుసు.
Tom knew that Mary was awake.	మేరీ మేల్కొని ఉన్నాడని టామ్ కి తెలుసు.
Tom noticed Mary was there.	మేరీ అక్కడ ఉన్నట్లు టామ్ గమనించాడు.
We were supposed to tell everyone to leave.	మేము ప్రతి ఒక్కరినీ వదిలి వెళ్ళమని చెప్పాల్సి ఉంది.
He can touch his nose with his tongue.	అతను తన నాలుకతో ముక్కును తాకగలడు.
It's not too hard.	ఇది చాలా కష్టం కాదు.
Tom wanted me to drive.	టామ్ నన్ను డ్రైవ్ చేయాలనుకున్నాడు.
There was a bridge across each river.	ప్రతి నదికి ఒక వంతెన ఉండేది.
Tom is the youngest of my three children.	టామ్ నా ముగ్గురు పిల్లలలో చిన్నవాడు.
The librarian looked quite sick.	లైబ్రేరియన్ చాలా అనారోగ్యంగా కనిపించాడు.
I don't really want to go fishing with Tom.	నేను నిజంగా టామ్‌తో చేపలు పట్టడానికి ఇష్టపడను.
Here's where they usually have dinner.	ఇక్కడ వారు సాధారణంగా విందు చేస్తారు.
Tom pointed to his chest.	టామ్ అతని ఛాతీ వైపు చూపించాడు.
Tom isn't a bus driver, is he?	టామ్ బస్సు డ్రైవర్ కాదు, అవునా?
I have no time left.	నాకు సమయం లేదు.
Tom read Mary a bedtime story.	టామ్ మేరీకి నిద్రవేళ కథ చదివాడు.
You were my inspiration.	మీరు నా ప్రేరణ.
I have news about Tom.	టామ్ గురించి నాకు వార్తలు ఉన్నాయి.
Tom works at a nearby restaurant.	టామ్ సమీపంలోని రెస్టారెంట్‌లో పనిచేస్తాడు.
Tom can't answer.	టామ్ సమాధానం చెప్పలేడు.
Her explanation of the problem was nonsense.	సమస్య గురించి ఆమె వివరణ అర్ధంలేనిది.
I want to be ready for anything.	నేను దేనికైనా సిద్ధంగా ఉండాలనుకుంటున్నాను.
You must clear the table.	మీరు పట్టికను క్లియర్ చేయాలి.
We will now report on this year's business results.	మేము ఇప్పుడు ఈ సంవత్సరం వ్యాపార ఫలితాలపై నివేదిస్తాము.
I wish I had Tom's brains.	నేను టామ్ యొక్క మెదడులను కలిగి ఉండాలని కోరుకుంటున్నాను.
Tom has got nowhere to go.	టామ్ ఎక్కడికి వెళ్ళలేదు.
We've all seen that before.	మనమందరం ఇంతకు ముందు చూశాము.
Tom seems bored.	టామ్ విసుగు చెందినట్లుంది.
I behaved myself.	నేనే ప్రవర్తించాను.
Our son was killed in the war.	మా కొడుకు యుద్ధంలో చంపబడ్డాడు.
I don't think that Tom is ever going to get married.	టామ్ ఎప్పుడూ పెళ్లి చేసుకోబోతున్నాడని నేను అనుకోను.
Make sure to back up all your files.	మీ అన్ని ఫైల్‌లను బ్యాకప్ చేయాలని నిర్ధారించుకోండి.
If Tom is happy, I'm happy.	టామ్ సంతోషంగా ఉంటే, నేను సంతోషంగా ఉన్నాను.
I will win the game next time.	నేను తదుపరిసారి ఆట గెలవను.
I haven't had this much fun in years.	నేను సంవత్సరాలలో చాలా ఆనందించలేదు.
That result was predictable.	ఆ ఫలితం able హించదగినది.
We aren't doing anything.	మేము ఏమీ చేయడం లేదు.
We're coming.	మేము వస్తున్నాము.
Official Information	అధికారిక సమాచారం
I'll phone you as soon as I get to the airport.	నేను విమానాశ్రయానికి వచ్చిన వెంటనే మీకు ఫోన్ చేస్తాను.
I told Tom to go to the police.	నేను టామ్‌ను పోలీసుల వద్దకు వెళ్ళమని చెప్పాను.
Tom is their leader.	టామ్ వారి నాయకుడు.
I thought Tom and Mary were married.	టామ్ మరియు మేరీ వివాహం చేసుకున్నారని నేను అనుకున్నాను.
It's pretty amazing.	ఇది చాలా అద్భుతంగా ఉంది.
Tom likes watching action movies.	టామ్ యాక్షన్ సినిమాలు చూడటం ఇష్టపడతాడు.
Tom said Mary was quite heavy.	టామ్ మేరీ చాలా బరువుగా ఉన్నాడు.
Not a sound was heard.	శబ్దం వినబడలేదు.
Tom sent Mary to summer camp.	టామ్ మేరీని సమ్మర్ క్యాంప్‌కు పంపాడు.
This isn't for sale.	ఇది అమ్మకానికి లేదు.
Happy Birthday to you.	నీకు పుట్టిన రోజు శుభాకాంక్షలు.
I really liked the movie.	నాకు సినిమా నిజంగా నచ్చింది.
I think that it's time for us to tell Tom the truth.	టామ్‌కు నిజం చెప్పే సమయం ఆసన్నమైందని నేను భావిస్తున్నాను.
There is probably an easy solution to the problem.	సమస్యకు సులభమైన పరిష్కారం బహుశా ఉంది.
Tom's career is over.	టామ్ కెరీర్ ముగిసింది.
Look what I found on my way home.	ఇంటికి వెళ్ళేటప్పుడు నేను కనుగొన్నదాన్ని చూడండి.
It's almost dawn and nothing's happened yet.	ఇది దాదాపు తెల్లవారుజాము మరియు ఇంకా ఏమీ జరగలేదు.
I know the boy.	నాకు అబ్బాయి తెలుసు.
I think Tom is gone.	టామ్ పోయిందని అనుకుంటున్నాను.
I did everything the way Tom told me to do it.	టామ్ చెప్పినట్లు చెప్పినట్లు నేను ప్రతిదీ చేసాను.
The police lowered their weapons.	పోలీసులు వారి ఆయుధాలను తగ్గించారు.
Let's forget it.	దాన్ని మరచిపోదాం.
Evil sometimes wins.	చెడు కొన్నిసార్లు గెలుస్తుంది.
Tom is walking in college premises.	టామ్ కాలేజీ ఆవరణలో నడుస్తున్నాడు.
This is the hottest summer that we have had in thirty years.	ముప్పై ఏళ్ళలో మనకు ఉన్న హాటెస్ట్ వేసవి ఇది.
Where exactly does Tom live?	టామ్ సరిగ్గా ఎక్కడ నివసిస్తాడు?
Tom told me you were afraid.	టామ్ నాకు భయపడ్డాడని చెప్పాడు.
I'd never seen you so afraid before.	నేను ఇంతకు ముందు మిమ్మల్ని ఇంత భయంతో చూడలేదు.
We need three cups.	మాకు మూడు కప్పులు అవసరం.
You must try and come to the party.	మీరు తప్పక ప్రయత్నించాలి మరియు పార్టీకి రావాలి.
It's an illusion.	ఇది ఒక భ్రమ.
I have had quite enough of his jokes.	నేను అతని జోకులు చాలా ఉన్నాయి.
That's probably what they'll say.	బహుశా వారు చెప్పేది అదే.
Please tell us what happened.	దయచేసి ఏమి జరిగిందో మాకు చెప్పండి.
I've fixed the radio for him.	నేను అతని కోసం రేడియోను పరిష్కరించాను.
I hate myself.	నన్ను నేను ద్వేషిస్తున్నాను.
I cannot possibly help you.	నేను మీకు సహాయం చేయలేను.
Tom turned down the radio.	టామ్ రేడియోను తిరస్కరించాడు.
You can't take it with you.	మీరు దానిని మీతో తీసుకోలేరు.
Things changed after that.	ఆ తర్వాత పరిస్థితులు మారిపోయాయి.
We're thinking about putting our house up for sale.	మేము మా ఇంటిని అమ్మకానికి పెట్టడం గురించి ఆలోచిస్తున్నాము.
During the break, I went to look for Tom in the lobby.	విరామ సమయంలో, నేను లాబీలో టామ్ కోసం వెతకడానికి వెళ్ళాను.
I never asked you to do that.	నేను ఎప్పుడూ అలా చేయమని మిమ్మల్ని అడగలేదు.
School begins in April.	పాఠశాల ఏప్రిల్‌లో ప్రారంభమవుతుంది.
Tom asked me for my phone number.	టామ్ నా ఫోన్ నంబర్ అడిగారు.
Tom couldn't wait until the weekend.	టామ్ వారాంతం వరకు వేచి ఉండలేకపోయాడు.
They say that Isabela died.	ఇసాబెలా మరణించాడని వారు అంటున్నారు.
I couldn't sleep last night, so I decided to watch a horror movie.	నేను గత రాత్రి నిద్రపోలేను, కాబట్టి నేను హర్రర్ సినిమా చూడాలని నిర్ణయించుకున్నాను.
The customer agrees.	కస్టమర్ అంగీకరిస్తాడు.
I'm quite lazy.	నేను చాలా బద్ధకంగా ఉన్నాను.
He will be back soon.	అతను త్వరలో తిరిగి వస్తాడు.
I want Tom to read this.	టామ్ దీన్ని చదవాలని నేను కోరుకుంటున్నాను.
Please show me how to do that.	దయచేసి దీన్ని ఎలా చేయాలో నాకు చూపించండి.
That's precisely what Tom did.	టామ్ చేసినది అదే.
Tom has an earache.	టామ్‌కు చెవి ఉంది.
I don't know Malayalam.	నాకు మలయాళం రాదు.
I have no money with me.	నా దగ్గర డబ్బు లేదు.
It started as a hobby.	ఇది ఒక అభిరుచిగా ప్రారంభమైంది.
Some people think that hang gliding is a dangerous sport.	కొంతమంది హాంగ్ గ్లైడింగ్ ప్రమాదకరమైన క్రీడ అని భావిస్తారు.
They'll kill me.	వారు నన్ను చంపుతారు.
You were treated unfairly.	మీకు అన్యాయంగా ప్రవర్తించారు.
Strange things happened that night.	ఆ రాత్రి వింతైన విషయాలు జరిగాయి.
Tom is going to miss you.	టామ్ మిమ్మల్ని కోల్పోతాడు.
That actress is as beautiful as ever.	ఆ నటి ఎప్పటిలాగే అందంగా ఉంది.
I can help you now.	నేను ఇప్పుడు మీకు సహాయం చేయగలను.
The plank froze to the ground.	ప్లాంక్ నేలమీద గడ్డకట్టింది.
Tom tried to hide his confusion.	టామ్ తన గందరగోళాన్ని దాచడానికి ప్రయత్నించాడు.
Why are running very slowly?	ఎందుకు చాలా నెమ్మదిగా నడుస్తున్నాయి?
Tom thinks that he's always right.	టామ్ అతను ఎప్పుడూ సరైనవాడు అని అనుకుంటాడు.
Don't panic!	భయపడవద్దు!
The cat is in the box.	పిల్లి పెట్టెలో ఉంది.
He is capable of teaching French.	అతను ఫ్రెంచ్ బోధించే సామర్థ్యం కలిగి ఉంటాడు.
I heard about what happened.	నేను ఏమి జరిగిందో విన్నాను.
That I can't tell you.	నేను మీకు చెప్పలేను.
Tom handed Mary a check for half a million dollars.	టామ్ మేరీకి అర మిలియన్ డాలర్ల చెక్కును ఇచ్చాడు.
Please lock the door.	దయచేసి తలుపు లాక్ చేయండి.
Thank you very much for the useful advice.	ఉపయోగకరమైన సలహా కోసం చాలా ధన్యవాదాలు.
We've hired a new coach.	మేము కొత్త కోచ్‌ను నియమించాము.
I'm sure it'll pass.	అది పాస్ అవుతుందని నేను ఖచ్చితంగా అనుకుంటున్నాను.
I think I can come over this afternoon.	నేను ఈ మధ్యాహ్నం రావచ్చని అనుకుంటున్నాను.
I don't think that we'll ever know what happened to Tom.	టామ్కు ఏమి జరిగిందో మనకు ఎప్పటికి తెలుస్తుందని నేను అనుకోను.
I wonder if Tom has ever been to Boston.	టామ్ ఎప్పుడైనా బోస్టన్‌కు వెళ్ళాడా అని నేను ఆశ్చర్యపోతున్నాను.
We have to get out of here fast.	మేము వేగంగా ఇక్కడి నుండి బయటపడాలి.
God	దేవుడు
I'd like to ask you for some advice.	నేను మిమ్మల్ని కొన్ని సలహాలు అడగాలనుకుంటున్నాను.
That's a nice thought.	ఇది మంచి ఆలోచన.
I won't have time this evening.	ఈ సాయంత్రం నాకు సమయం ఉండదు.
It is my strict warning.	ఇది నా కఠినమైన హెచ్చరిక.
If he's still alive, he'd be very old by now.	అతను ఇంకా బతికే ఉంటే, అతను ఇప్పుడు చాలా వయస్సులో ఉంటాడు.
I will accept the work, provided that you help me.	మీరు నాకు సహాయం చేస్తే నేను పనిని అంగీకరిస్తాను.
RRR is an epic action drama movie.	RRR ఒక ఎపిక్ యాక్షన్ డ్రామా మూవీ.
Tom looked out the window and saw Mary.	టామ్ కిటికీలోంచి చూస్తూ మేరీని చూశాడు.
Do you have a birthmark?	మీకు బర్త్‌మార్క్ ఉందా?
Source	మూలం
Hindi language is known as Hindustan ki Bhasha.	హిందీ భాషను హిందుస్థాన్ కి భాష అంటారు.
Tom has started writing a novel.	టామ్ ఒక నవల రాయడం ప్రారంభించాడు.
Never hesitate to tell the truth.	నిజం చెప్పడానికి ఎప్పుడూ వెనుకాడరు.
Are you staying for dinner?	మీరు విందు కోసం ఉంటున్నారా?
I'm not telling you his name.	నేను అతని పేరు మీకు చెప్పడం లేదు.
I'd have told you that.	నేను మీకు చెప్పాను.
The milk tastes sour.	పాలు పుల్లని రుచి చూస్తాయి.
You can pretend to be serious, but you can't pretend to be funny.	మీరు గంభీరంగా ఉన్నట్లు నటించవచ్చు, కానీ మీరు ఫన్నీగా నటించలేరు.
That's a stupid rule.	అది తెలివితక్కువ నియమం.
Tom is old enough to drive.	టామ్ డ్రైవ్ చేసేంత వయస్సు.
Tom told me that he'd be home on Monday.	టామ్ సోమవారం ఇంటికి వస్తానని చెప్పాడు.
Tom wants to play tennis with Mary.	టామ్ మేరీతో టెన్నిస్ ఆడాలనుకుంటున్నాడు.
I wasn't looking at you.	నేను మీ వైపు చూడటం లేదు.
He is now almost as tall as his father is.	అతను ఇప్పుడు తన తండ్రి ఉన్నంత ఎత్తులో ఉన్నాడు.
Did you forget to feed the dog?	మీరు కుక్కకు ఆహారం ఇవ్వడం మర్చిపోయారా?
Suneetha is trying to learn Tamil.	సునీత తమిళం నేర్చుకోవడానికి ప్రయత్నిస్తోంది.
Why	ఎందుకు
Tom didn't even know who Mary was.	టామ్ మేరీ ఎవరో కూడా తెలియదు.
మీరు తప్పు అని నేను మీకు భరోసా ఇవ్వగలను.	I can assure you that you are wrong.
నేను ఏమి చేయాలనుకుంటున్నానో నాకు తెలియదు.	I don't know what you want me to do.
టామ్ ప్రస్తుతం తన ఇంటి పని చేయాలనుకోవడం లేదు.	Tom doesn't want to do his homework right now.
టామ్ ప్రతిభావంతులైన యువకుడు.	Tom is a talented young man.
మీరు ఎక్కడికి వెళుతున్నారు	Where are you going
నేను చాలా అదృష్టవంతుడిని.	I'm a very lucky man.
నేను మీలాగే పేదవాడిని.	I used to be poor like you.
ఇంత దూరం నడవడానికి అతను మంచి వాకర్ అయి ఉండాలి.	He must be a good walker to have walked such a long distance.
ఇది పెట్టె వెలుపల ఆలోచించడానికి మరియు విభిన్న వ్యూహాలు మరియు ఆలోచనలను అన్వేషించడానికి ఆటగాళ్లను ప్రోత్సహించడం ద్వారా సృజనాత్మకతను మెరుగుపరుస్తుంది.	It can  enhance creativity by encouraging players to think outside the box and explore different strategies and ideas.
నాగ వెంకట సాయి విభిన్న నైపుణ్యాలు కలిగిన బహుముఖ ప్రజ్ఞాశాలి.	Naga Venkata Sai is a multi-talented individual with a diverse range of skills.
విదేశీయుల బృందం ఎడోకు చేరుకుంది, మరో మాటలో చెప్పాలంటే టోక్యో.	A group of foreigners arrived in Edo, in other words Tokyo.
టామ్ ఒక స్కీమర్.	Tom is a schemer.
పిల్లలందరూ మీకు ఇష్టం.	All the children like you.
అతను కొద్దిసేపటి క్రితం ఇంటికి తిరిగి వచ్చాడు.	He came back home a while ago.
గొప్ప సాంస్కృతిక వారసత్వం మరియు అభివృద్ధి చెందుతున్న ఆర్థిక వ్యవస్థతో శక్తివంతమైన నగరం.	A vibrant city with a rich cultural heritage and a thriving economy.
టామ్ నాకు చెస్ ఆడటం నేర్పించాడు.	Tom taught me to play chess.
ఆమె సందర్శించిన వ్యక్తుల గురించి ఆమె పుస్తకం రాసింది.	She wrote the book about people she visited.
ఆమె గత రాత్రి వచ్చిందని నేను కోరుకుంటున్నాను.	I wish she had come last night.
నేను ఇక ఎందుకు బాధపడుతున్నానో నాకు తెలియదు.	I don't know why I even bother anymore.
నటుడు	actor
మీరు ఎందుకు ఆవలిస్తున్నారు?	Why are you yawning?
ఆమె చింతిస్తున్న సమయం వస్తుంది.	The time will come when she'll regret it.
ఇది మా నిర్ణయం.	This is our decision.
నేను వెంటనే అతన్ని గుర్తించాను.	I recognized him immediately.
ఇది సుదీర్ఘ యాత్ర కానుంది.	It's going to be a long trip.
అతను తక్సేడో ధరించాడు.	He was wearing a tuxedo.
టామ్ మంచు గుండా పడిపోయాడు.	Tom fell through the ice.
ఆదేశాలు అడగడానికి మనం గ్యాస్ స్టేషన్ వద్ద ఆగాలి.	Maybe we should stop at a gas station to ask for directions.
టామ్‌కు ఇది అక్కరలేదు.	Tom doesn't want this.
అతను దీన్ని ఎలా చేస్తాడు?	How does he do this?
వారంతా నటులు.	They were all actors.
మా సరదాని నాశనం చేయవద్దు.	Don't ruin our fun.
ప్రపంచంలో అత్యధికంగా సందర్శించే తీర్థయాత్రలలో ఇది ఒకటి.	It  is one of the most visited pilgrimage sites in the world.
ఇల్లు	house
ఎవరూ ఫిర్యాదు చేయలేదు.	Nobody complained.
మీరు సినిమాలు చూడలేదా?	Don't you watch movies?
ఒక దొంగకు తగినంత తాడు ఇవ్వండి మరియు అతను ఉరి వేసుకుంటాడు.	Give a thief enough rope and he'll hang himself.
అతను చిక్కుకోలేదు.	He didn't get caught.
టామ్ చేతివ్రాత చదవలేనిది.	Tom's handwriting is unreadable.
నేను అతనిని క్రెడిట్ పొందటానికి అనుమతించాను.	I let him get the credit.
టామ్ తప్పించుకునేంత తెలివైనవాడు.	Tom was smart enough to escape.
జరిగే చెత్త విషయం ఏమిటి?	What's the worst thing that could happen?
టామ్ సోదరి అతనికి న్యాయవాదిగా మారడానికి మార్గం సుగమం చేసింది.	Tom's sister paved the way for him to become a lawyer.
నార్మన్లు 1066 లో ఇంగ్లాండ్‌ను జయించారు.	The Normans conquered England in 1066.
నేను ఎన్ని దేశాలను సందర్శించాను అని టామ్ నన్ను అడిగాడు.	Tom asked me how many countries I'd visited.
మీరు కోరుకుంటే నేను వెళ్తాను.	I'll go if you will.
టామ్ ఎల్లప్పుడూ మేరీని గుర్తుంచుకుంటాడు.	Tom will always remember Mary.
టామ్ తాను భయపడ్డానని ఒప్పుకోవటానికి ఇష్టపడలేదు.	Tom didn't want to admit he was scared.
టామ్ హలో చెప్పాలనుకుంటున్నాడు.	Tom wants to say hello.
S. P. B వివిధ భాషలలో 40,000 పాటలు పాడారు మరియు అతని కాలంలోని అత్యంత బహుముఖ మరియు ప్రసిద్ధ గాయకులలో ఒకరు.	S. P. B sang over 40,000 songs in various languages and was one of the most versatile and popular singers of his time.
టామ్ నన్ను అడిగినట్లు నేను చేసాను.	I did what Tom asked me to do.
టామ్ ఇప్పటికీ te త్సాహిక వ్యక్తి.	Tom is still an amateur.
నష్టం భీమా పరిధిలోకి వచ్చింది.	The damage was covered by insurance.
నేను చాలా ఏడుస్తాను.	I used to cry a lot.
మీ కొడుకు పేరు ఏమిటి?	What's your son's name?
మీరు నిజంగా నా గురించి కలలు కన్నారా?	Did you really dream about me?
టామ్ తన కారులో దిగి వెళ్ళిపోయాడు.	Tom got in his car and left.
టామ్ మాంసం మీద ఉంచే మసాలా మిరియాలు మాత్రమే.	The only spice Tom puts on meat is pepper.
టామ్ తెలివితక్కువవాడు, చెస్ ఆటకు మేరీని సవాలు చేసేవాడు.	Tom was stupid enough to challenge Mary to a game of chess.
నేను దీనికి వ్యతిరేకం అని మీరు ఏమనుకుంటున్నారు?	What makes you think that I'm against that?
అధ్యక్షుడు మన్రో బానిస యజమాని.	President Monroe was a slave-owner.
నేను అందరినీ కోల్పోతాను.	I'll miss everyone.
అతను విచిత్రమైన వ్యక్తి.	He's a weird guy.
టామ్ స్తంభించిపోయాడు.	Tom's paralyzed.
ఏ గొడుగు మీది?	Which umbrella is yours?
ఆమె కారు నడపడం నేర్చుకుంటుంది.	She is learning how to drive a car.
రేపు వర్షం పడవచ్చు.	It may rain tomorrow.
మీ తల్లి పుట్టినరోజు కోసం మీరు ఏమి కొనాలనుకుంటున్నారు?	What would you like to buy your mother for her birthday?
అది మనకు ఎందుకు జరగాలి?	Why did that have to happen to us?
టామ్ ఇప్పటికీ నియమాలను నేర్చుకుంటున్నాడు.	Tom is still learning the rules.
నేను ఇంకా ఏమీ సాధించలేదు.	I haven't accomplished anything yet.
టామ్ మేరీకి సహాయం చేయడానికి నిరాకరించాడు.	Tom refused to help Mary.
ప్రతి ఆరు గంటలకు నా medicine షధం తీసుకోవాలి.	I have to take my medicine every six hours.
నాకు మంచి సమయం వచ్చింది.	I had a good time.
టామ్ నిజంగా అలాంటిదే చేస్తాడా అని నేను ఆశ్చర్యపోతున్నాను.	I wonder if Tom would really do something like that.
గంట ఉంది.	There's the bell.
నేను మీ హృదయాన్ని విచ్ఛిన్నం చేయాలనుకోవడం లేదు.	I don't want to break your heart.
వారు సాధారణ ప్రయోజనాలతో కట్టుబడి ఉంటారు.	They are bound together by common interests.
టామ్ మ్యాప్‌ను టేబుల్‌పై ఉంచాడు.	Tom put the map on the table.
మేము భద్రత కోసం కలిసి ఉంచాము.	We kept together for safety.
ఇది నిజం కాదని నేను ఎక్కడో చదివాను.	I've read somewhere that it's not true.
టామ్ వారు చెప్పినవన్నీ విన్నారు.	Tom heard everything they said.
టామ్ మరణం మర్మమైనది.	Tom's death was mysterious.
ఈ సంవత్సరం వరి పంట పేలవంగా ఉంది.	The rice crop is poor this year.
నేను మీ కాల్‌ను ఆశిస్తున్నాను.	I've been expecting your call.
ఇది ఎనభై మీటర్ల పొడవు.	It was eighty meters long.
టామ్ మీకు అలా చేయమని చెప్పాడా?	Was Tom the one who told you to do that?
సాహిత్యం తనకు అర్థం కాని భాషలో ఉన్నప్పటికీ టామ్ ఈ పాటను ఇష్టపడ్డాడు.	Tom loved the song even though the lyrics were in a language he didn't understand.
టామ్ మాత్రమే కూర్చోలేదు.	Tom was the only one not sitting.
టామ్ చెప్పిన దేన్నీ మీరు నమ్మకూడదు.	You shouldn't trust anything Tom says.
దీని గురించి ఎంత మందికి తెలుసు?	How many people know about this?
చెత్త మన వెనుక ఉంది.	The worst is behind us.
రాముడు రావణుడిని చంపాడు.	ram kills ravana.
రజనీకాంత్ తమిళం, తెలుగు, హిందీ, కన్నడ మరియు ఇతర భారతీయ భాషల చిత్రాలలో పనిచేసిన ప్రముఖ భారతీయ నటుడు.	Rajinikanth is a popular Indian actor who has worked in Tamil, Telugu, Hindi, Kannada, and other Indian languages films.
నేను తలుపు మూసాను.	I closed the door.
ఈ మధ్యాహ్నం నాకు ఏమీ లేదు.	I have nothing to do this afternoon.
దీని కాపీని మీరు కలిగి ఉండాలని నేను కోరుకుంటున్నాను.	I want you to have a copy of this.
నేను ఈ ఆటను ద్వేషిస్తున్నాను.	I hate this game.
నేను ఈ ఆపిల్ల ఒకటి తింటే సరేనా?	Is it OK if I eat one of these apples?
మీ పని గురించి మాట్లాడుకుందాం.	Let's talk about your work.
ఎయిర్ కండీషనర్ పనిచేయదు.	The air conditioner doesn't work.
నేను మీ అపార్ట్మెంట్ను ఇష్టపడుతున్నాను.	I like your apartment.
దయచేసి రెస్టారెంట్ ఎక్కడ ఉందో చెప్పగలరా?	Can you please tell me where the restaurant is?
మీకు ఎప్పుడూ బాయ్‌ఫ్రెండ్ లేరు, లేదా?	You've never had a boyfriend, have you?
మీరు వాటిని చూశారు, లేదా?	You saw them, didn't you?
మేము చాలా కాఫీ తాగాము.	We drank a lot of coffee.
నా తల్లిదండ్రులు నన్ను డేటింగ్ చేయనివ్వరు.	My parents won't let me date.
నేను భోజనప్రియుడిని కాదు.	I am not a foodie.
నాకు లేఖ మెయిల్ చేయడం గుర్తులేదు.	I don't remember mailing the letter.
టామ్ మేరీకి తన కాలు మీద ఉన్న మచ్చను చూపించాడు.	Tom showed Mary the scar on his leg.
నేను చాలా అపరాధభావంతో ఉన్నాను.	I feel very guilty.
టామ్ మరియు మేరీ ఒకరినొకరు అర్థం చేసుకున్నారు.	Tom and Mary understood each other.
నేను ఈ రోజు 8 గంటలకు లేచాను.	I got up at 8 o'clock today.
ఆ విండో తెరుచుకుంటుందా?	Does that window open?
టామ్ మొదటివాడు అని నాకు తెలుసు.	I know that Tom was first.
దయచేసి దీన్ని రహస్యంగా ఉంచండి.	Please keep this a secret.
తన ఎడమ కాలు బాధిస్తుందని టామ్ చెప్పాడు.	Tom says his left leg hurts.
నా తండ్రి నాకు గుర్రాన్ని కొనాలని యోచిస్తున్నట్లు చెప్పారు.	My father says he's planning to buy me a horse.
టామ్ ఆస్ట్రేలియా వెళ్ళాలని యోచిస్తున్నాడని మీకు తెలియదా?	Didn't you know that Tom was planning to go to Australia?
ఉచిత పుస్తకాలు అందుబాటులో ఉన్నాయి	Free books available
రాజుకు అడవులు అంటే చాలా ఇష్టం	King loves forestation.
మీకు చలి అనిపించలేదా?	Don't you feel cold?
టామ్ మరియు మేరీ విడాకులు తీసుకోవాలని యోచిస్తున్నారు.	Tom and Mary are planning to get a divorce.
వారు రాకెట్ పంపబోతున్నారు.	They are going to send up a rocket.
టామ్ మనం చేయవలసిన పనుల జాబితాను వ్రాశాడు.	Tom has written down a list of things we need to do.
ఇది నా దృష్టిని ఆకర్షించింది.	It caught my eye.
ఈ సమావేశంలో మేరీ లేడని టామ్ చెప్పారు.	Tom says Mary wasn't at the meeting.
మేము దానిని ఎప్పుడు ఉపయోగించబోతున్నాం?	When are we going to use it?
ఈ వీధికి మరొక పేరు ఉండేది.	This street used to have another name.
మీరు ఆ సిగరెట్ బయట పెట్టాలని నేను కోరుకుంటున్నాను.	I want you to put out that cigarette.
మీరు అక్కడ ఉండబోతున్నారని నాకు తెలియదు.	I didn't know you were going to be there.
టామ్ బహుశా ఇప్పటికీ దాక్కున్నాడు.	Tom is probably still hiding.
మనల్ని మనం మోసం చేసుకోనివ్వండి.	Let's not fool ourselves.
టామ్ తన డెబ్బైలలో మరణించాడు.	Tom died in his seventies.
పార్టీ తొమ్మిదికి ముగిసింది.	The party finished at nine.
టామ్ ఇంతకు ముందెన్నడూ కారు నడపలేదు.	Tom has never driven a car before.
టామ్ ఒక పడవ కొనడానికి భరించలేడు.	Tom can't afford to buy a yacht.
మీరు ఉచితంగా పొందగలిగినప్పుడు ఎందుకు చెల్లించాలి?	Why pay when you can get it for free?
అంటార్కిటికాలో అనేక నౌకలు సముద్రపు మంచులో చిక్కుకున్నాయి.	Several ships are stuck in sea ice in Antarctica.
మేము కొంచెం ముందుగానే ఉన్నాము.	We're a little early.
ఆ మనిషి చనిపోయాడు.	That man is dead.
టామ్ ఉద్యోగాల మధ్య ఉన్నాడు.	Tom is between jobs.
టామ్ దానిని నాకు వివరించాల్సిన అవసరం లేదు.	Tom didn't need to explain it to me.
ఈ బృందంలో నలుగురు యువకులు ఉన్నారు.	The group was made up of four young men.
సంవత్సరానికి ఎన్నిసార్లు మీరు స్కీయింగ్‌కు వెళతారు?	How many times a year do you go skiing?
టామ్ మరియు మేరీ ఒంటరిగా ఉన్నారు.	Tom and Mary left alone.
ప్రజలు ఏమనుకుంటున్నారో నేను పట్టించుకోను.	I don't care what people think.
తిమింగలాలు చిన్న చేపలను తింటాయి.	Whales feed on small fish.
నేను సహాయం చేసాను.	I helped.
నేను త్వరలో తిరిగి పిలుస్తాను.	I'll call back soon.
తెల్లవారేముందు ఎప్పుడూ చీకటిగానే ఉంటుంది.	It's always darkest before the dawn.
టామ్ ఇంకా తన పేరును కూడా వ్రాయలేడు.	Tom can't even write his own name yet.
టామ్ ఎందుకు వెళ్ళలేడు?	Why can't Tom leave?
టామ్ నా మంచి విద్యార్థులలో ఒకడు.	Tom was one of my better students.
ఆమె దిగుమతి చేసుకున్న కారును నడుపుతుంది.	She drives an imported car.
టామ్ నేను అతని కోసం అలా చేయాలనుకున్నాను.	Tom wanted me to do that for him.
మిమ్మల్ని ఎవరూ బాధపెట్టనివ్వను.	I won't let anybody hurt you.
ఇది ఉన్నత స్థాయి గృహాలు, రెస్టారెంట్లు మరియు షాపింగ్ కేంద్రాలకు ప్రసిద్ధి చెందిన ప్రధాన నివాస ప్రాంతం.	It is a prime residential area that is known for its upscale homes, restaurants, and shopping centers.
మీరు ఇప్పటికే దాని గురించి మరచిపోయారు.	You've probably forgotten about it already.
మీరు వేచి ఉండలేరని నాకు తెలుసు.	I know you can't wait.
టామ్ తన బ్లాక్ సూట్ మరియు వైట్ టై ధరించాడు.	Tom put on his black suit and white tie.
మీరు ఇప్పటివరకు చేసిన ఉత్తమ కచేరీ ఏమిటి?	What is the best concert you've ever been to?
నేను కాలేజీ నుండి తప్పుకొని ఉద్యోగం పొందవలసి వచ్చింది.	I had to drop out of college and get a job.
టామ్ చాలా అరుదుగా ఇంట్లోనే ఉంటాడు.	Tom is seldom home.
అది సరిపోతుందా?	Is that enough?
టామ్ రోడ్డు దాటడానికి ముందు రెండు మార్గాలు చూశాడు.	Tom looked both ways before crossing the road.
మీరు ఒక గ్లాసు నీరు కావాలనుకుంటున్నారా?	Would you like a glass of water?
పేద అమ్మాయి అంధురాలైంది.	The poor girl went blind.
తెలుగును ఇటాలియన్ ఆఫ్ ది ఈస్ట్ అని పిలుస్తారు.	Telugu is known as italian of the east.
విక్రయించబడింది	Sold
మా కోసం పనిచేయడానికి మీకు ఇంకా ఆసక్తి ఉందా?	Are you still interested in working for us?
ఇది ఇప్పుడు ఉంది.	It's there now.
మీరు నమ్మినా, చేయకపోయినా, నేను మీరు చేసినంత మాత్రాన ఈ విషయాన్ని పొందాలనుకుంటున్నాను.	Whether you believe it or not, I want to get this thing over with as much as you do.
టామ్ ఎక్కడ ఉన్నారో మీరు నాకు చెప్పగలరా?	Could you tell me where Tom is?
మేము చనిపోయామని టామ్ భావిస్తాడు.	Tom thinks we're dead.
నిన్న నువ్వు ఎక్కడ ఉన్నావు?	Where were you yesterday?
మేము ఆపిల్ల తింటున్నాము.	We were eating apples.
టామ్ మీరు బిజీగా ఉన్నారని చెప్పారు.	Tom said you were busy.
టామ్ చిరాకు గొంతులో మా వైపు అరిచాడు.	Tom shouted at us in a gruff voice.
నా గోప్యతకు నేను విలువ ఇస్తున్నాను.	I value my privacy.
పురుషులందరూ టామ్ మాదిరిగానే దుస్తులు ధరించారు.	All of the men were dressed similarly to Tom.
మొక్కలు	plants
ఆమె అంచనాలు నిజమయ్యాయి.	Her predictions have come true.
దాన్ని ఆపివేయండి.	Turn it off.
ఇంకా ఏమి చేయాలో నేను చూస్తాను.	I'll see what else needs to be done.
వారు కలిసి ప్రయాణించారు.	They traveled together.
టామ్ నా కోసం పని చేయలేదు.	Tom wasn't working for me.
టామ్ నేను అతనికి సహాయం చేయాలనుకున్నాను.	Tom wanted me to help him.
దీనికి కొంత సమయం పడుతుంది.	This will take some time.
గదిలోకి ప్రవేశించినప్పుడు టామ్ నవ్వలేదు.	Tom wasn't smiling when he entered the room.
అమ్మాయి	girl
టామ్ ఇంట్లో ఉన్నట్లు నాకు తెలియదు.	I didn't know Tom was at home.
మీరు ముఖాలను గుర్తుంచుకోవడంలో మంచివా?	Are you good at remembering faces?
టామ్ బంతిని గట్టిగా కొట్టాడు, అతను బ్యాట్ను విభజించాడు.	Tom hit the ball so hard he split the bat.
నేను చాలా ఉత్సాహంగా ఉన్నాను.	I was very excited.
ఇది మీకు కష్టమని నాకు తెలుసు.	I knew this would be hard for you.
నా తాతకు బూడిద జుట్టు ఉంది.	My grandfather has gray hair.
టామ్ మరియు మేరీ కలిసి పనిచేయలేదా?	Don't Tom and Mary work together?
నా మనస్సులో విషయాలు ఉన్నాయి.	I have things on my mind.
టామ్ నన్ను మేరీతో కలిసి ఉండనివ్వండి.	Tom let me stay with Mary.
మీరు త్వరగా కోలుకున్నారు.	You recovered quickly.
సునీల్ అంతిమ హాస్యనటుడు.	Sunil is an ultimate comedian.
మీరు ఏమి చేయాలనుకుంటున్నారు?	What are you planning on doing?
మీకు ఎన్ని ఆంగ్ల పదాలు తెలుసు?	How many English words do you know?
ఇవన్నీ మీరు ఇంతకు ముందు ఎందుకు నాకు చెప్పలేదు?	Why didn't you tell me all this before?
అది విచిత్రంగా అనిపించింది.	That sounded weird.
టామ్‌ను కలవడం నాకు చాలా అనుభవం.	Meeting Tom was quite an experience for me.
టామ్కు ఏమి చేయాలో ఖచ్చితంగా తెలియదు.	Tom had absolutely no idea what to do.
శ్రేయా ఘోషల్ చాలా ప్రజాదరణ పొందిన మరియు ప్రతిభావంతులైన భారతీయ నేపథ్య గాయని.	Shreya Ghoshal is a very popular and talented Indian playback singer.
ఇది పొరపాటు.	It's likely a mistake.
నేను వేచి ఉండాలని టామ్ కి చెప్పాను.	I told Tom you'd wait.
టామ్ దీనిని అంతం చేయాలనుకుంటున్నాడు.	Tom wants to end this.
తెలుగు వ్యాకరణం	telugu grammer
నేను సలహా ఇవ్వవచ్చా?	Can I offer a suggestion?
నేను ఎక్కడ సైన్ అప్ చేయాలి?	Where do I sign up?
మీరు మరేదైనా చేస్తున్నారా?	Do you do anything else?
అవి ఆకుపచ్చగా ఉన్నాయి.	They're green.
నాకు సంగీతానికి చెవి లేదు.	It's a pity that I have no ear for music.
పార్క్ చేయడానికి మరెక్కడా లేదు.	There isn't anywhere else to park.
టామ్ మేరీని సందర్శించాడు.	Tom visited Mary.
టామ్ ఇరుక్కుపోయాడు.	Tom is stuck.
మీరు నా పాదాల మీద నిలబడి ఉన్నారు.	You're standing on my foot.
టామ్ విషపూరితమైన ఏదో తిన్నందున అతని కడుపు పంప్ చేయటానికి వారు ఆసుపత్రికి తీసుకువెళ్లారు.	They took Tom to the hospital to have his stomach pumped because he ate something poisonous.
మీరు అద్భుతమైన రచయిత.	You're an excellent writer.
మేము మీపై ఏమీ ఆరోపణలు చేయడం లేదు.	We're not accusing you of anything.
నేను రాత్రి సమయంలో మూడుసార్లు మేల్కొన్నాను.	I woke up three times during the night.
మీరు నాతో ఎందుకు మాట్లాడాలనుకున్నారు?	Why did you want to speak to me?
టామ్ తన తలుపులు లాక్ చేశాడు.	Tom locked his doors.
నేను బాగున్నాను.	I think I feel better.
అది ఏమిటి?	What can it be?
నేను వివాహం చేసుకోవాలనుకున్న అమ్మాయి వేరొకరిని వివాహం చేసుకుంది.	The girl I wanted to marry married somebody else.
ఇప్పుడు తినడానికి తగినంత సమయం లేదు.	There's not enough time to eat now.
వారిలో ఎంతమంది ప్రాణాలతో బయటపడ్డారో తెలియదు.	It's not known how many of them survived.
నేను కుక్కను చూస్తాను.	I see the dog.
అతను తరచుగా అనారోగ్యానికి గురవుతాడు.	He often gets sick.
మా రైలు సమయానికి వచ్చింది.	Our train arrived on time.
టామ్ వద్ద చాలా పుస్తకాలు లేవు.	Tom doesn't have many books.
సాక్షి ఉందని మీరు మాకు ఎందుకు చెప్పలేదు?	Why didn't you tell us there was a witness?
నేను క్యోటో, మరియు నారాలను కూడా సందర్శించాలని ఆలోచిస్తున్నాను.	I am planning to visit Kyoto, and Nara as well.
దొంగ ఈ తలుపు ద్వారా ఇంట్లోకి వచ్చాడు.	The burglar came into the house through this door.
టామ్ వదిలి వెళ్ళడం ఇష్టం లేదు.	Tom doesn't want to leave.
ప్రజలు దీనిని ఉపయోగిస్తారని నేను అనుకుంటున్నాను.	I do think people will use it.
ఆయన మరణం మన దేశానికి ఎంతో నష్టమే.	His death was a great loss to our country.
అందరూ ఇంకా ఇక్కడ ఉన్నారని నేను అనుకోను.	I don't think that everyone is here yet.
మీకు నాణ్యత కావాలంటే, దాని కోసం చెల్లించండి.	If you want quality, pay for it.
నీరు మంచు చల్లగా ఉంది.	The water was ice cold.
నాలో ఏమి జరుగుతుందో నేను పట్టించుకోను.	I don't care what will become of me.
బంస్ లాగా దుస్తులు ధరించవద్దు.	Don't come dressed like bums.
దాని కోసం వారి మాటను తీసుకోకండి.	Don't take their word for it.
భారతీయుడు	Indian
మేము ఒక్కసారి కలిసి చేపలు పట్టడానికి వెళ్తాము.	We go fishing together once in a while.
టామ్‌కు పోటీ నచ్చలేదు.	Tom doesn't like competition.
మేరీ ఏమి చేయాలో టామ్కు తెలియదు.	Tom didn't know what Mary needed to do.
అందుబాటులో ఉంది	Available
భోజనానికి బయటికి వెళ్లడం ఎలా?	How about going out for lunch?
అతని కాళ్ళు పొడవుగా ఉన్నాయి.	His legs are long.
మేము మధ్యాహ్నం అంతా ఇక్కడే ఉండబోతున్నాం.	We're going to be here all afternoon.
టామ్‌కు నియమాలు తెలుసు.	Tom knows the rules.
రెండు సమాధానాలు రెండూ సరైనవి.	The two answers are both correct.
టామ్ తన సూట్‌కేస్‌ను తీసుకెళ్లమని అడిగాడు.	Tom asked me to carry his suitcase.
నాకు తేనె అంటే ఇష్టం.	I like honey.
టామ్ ఇప్పుడు ఎక్కువగా తినడం.	Tom is most likely eating now.
నేను వేరే ఏమీ తినలేదు.	I didn't eat anything else.
మేము టామ్‌కు సహాయం చేస్తున్నాము.	We've been helping Tom.
నన్ను రక్షించడం ఆపు.	Stop protecting me.
మేరీ పాత పనిమనిషిగా ఉండటానికి ఇష్టపడదు.	Mary doesn't want to end up being an old maid.
ఇది ఏమిటి?	What do you think this is?
ఆసియా యూరప్ కంటే నాలుగు రెట్లు ఎక్కువ.	Asia is roughly four times the size of Europe.
టామ్ తనకు బాగా ఈత కొట్టడం తెలియదని చెప్పాడు.	Tom said he didn't know how to swim very well.
నేను దీనికి అర్హుడని నాకు తెలుసు.	I know I deserve this.
మాకు ఉమ్మడిగా ఏమీ లేదు.	We have nothing in common.
టామ్ ఎంత డబ్బు సంపాదించాడని మీరు అనుకుంటున్నారు?	How much money do you think Tom makes?
మీరు అతన్ని మోసంతో తప్పించుకోకూడదు.	You shouldn't let him get away with cheating.
నేను నా వేలు కత్తిరించాను.	I have cut my finger.
మీరు ఇక్కడ ఒంటరిగా నివసిస్తున్నారు, లేదా?	You live here alone, don't you?
టామ్ హాట్ బ్లడెడ్ వ్యక్తి.	Tom is a hot-blooded individual.
అతను ఉదయం ఎనిమిది గంటలకు లేచాడు.	He got up at eight in the morning.
సమాధానం కనుగొనడం అసాధ్యం.	It was impossible to find an answer.
ఆమెతో హవాయికి వెళ్లడాన్ని నేను ఎప్పటికీ మర్చిపోలేను.	I'll never forget going to Hawaii with her.
అతను తిరిగి రాగానే బయలుదేరదాం.	Let's leave as soon as he gets back.
మేమిద్దరం కలిసి బడికి వెళ్తాం.	We go to school together.
మీ పని నాకు చాలా ఇష్టం.	I like your work.
మీకు తెలిసిన భాషలు ఏమిటి?	What are the languages do you know?
బెంచ్ మీద కూర్చుందాం.	Let's sit down on the bench.
ఆమె అతనికి ఒక గడియారం ఇచ్చింది.	She gave him a clock.
టామ్ మరియు నేను ప్రతి ఉదయం కలిసి పాఠశాలకు నడుస్తాము.	Tom and I walk to school together every morning.
మీరు టామ్‌ను వివాహం చేసుకోవాలి.	You should marry Tom.
ఇది వాడుకలో లేదు.	It's obsolete.
టామ్‌కు అధిక జ్వరం ఉంది.	Tom has a high fever.
నేను మీకు భారం అవుతాను అని భయపడుతున్నాను.	I'm afraid I'll be a burden to you.
ఏమి జరిగిందో మేము సిద్ధంగా లేము.	We weren't prepared for what happened.
అతను తన మాటలోని వ్యక్తి.	He is a man of his word.
ఈ కుర్చీ తీసుకోండి.	Take this chair. It's sturdy.
నేను బాగా అలసిపోయాను	i am very tired
టామ్ కేక్ తింటున్నాడు.	Tom is eating a cake.
టామ్ మాట్లాడుతూ మేరీ మరియు నేను దానిని మనమే చేయగలమా అని ఆలోచిస్తున్నానని చెప్పాడు.	Tom said he wondered if Mary and I'd be able to do that by ourselves.
ఇది ఎలా అనిపిస్తుందో నాకు తెలుసు.	I know how it feels.
నేను చెప్పినట్లు గుర్తు.	I remember saying that.
టామ్ చిన్నతనంలో బోస్టన్‌లో నివసించాడు.	Tom lived in Boston when he was a child.
టామ్ ఇసుకతో ట్రక్కును ఎక్కించాడు.	Tom loaded the truck with sand.
టామ్, మీ వయస్సు ఎంత?	How old are you, Tom?
మేము ప్రతిచోటా మీ కోసం వెతుకుతున్నాము.	We've been looking for you everywhere.
ఎవరూ ఆమెను ప్రోత్సహించలేదు.	No one encouraged her.
త్వరలోనే చాలా కష్టపడి వర్షం పడటం ప్రారంభమైంది.	It soon began to rain very hard.
ఆమె చెప్పేది నమ్మవద్దని ఆయన నాకు సలహా ఇచ్చారు.	He advised me not to believe what she says.
టామ్ మాత్రమే అలా చేయగలడు, నేను అనుకుంటున్నాను.	Tom is the only person who can do that, I think.
దయచేసి దాని గురించి ఏదైనా చేయండి.	Please do something about it.
అది ఒక అనుభవం.	That was an experience.
డాక్టర్ అతని పల్స్ తీసుకున్నాడు.	The doctor took his pulse.
మీరు టామ్‌కు సందేశం ఇవ్వాలనుకుంటున్నాను.	I want you to give a message to Tom.
మీరు మాతో వెళ్లాలని అనుకోరని నాకు తెలుసు.	I knew you wouldn't want to go with us.
అతను ఎనిమిదేళ్ళ వయసులో తల్లిదండ్రులను విడిచిపెట్టాడు.	He left his parents when he was eight years old.
టామ్ మేరీని చంపాడని నేను అనుకోను.	I don't think Tom killed Mary.
టామ్ ఈ రోజు గెలవలేడు.	Tom will unlikely win today.
నన్ను కలవడానికి ఎవరైనా స్టేషన్‌లో ఉంటారా?	Will anybody be at the station to meet me?
నేను కొన్ని మార్పులు చేయాలనుకుంటున్నాను.	I want to make some changes.
టామ్ ఇక్కడే ఉంటానని చెప్పిన సమయం మీకు గుర్తుందా?	Do you remember what time Tom said he'd be here?
టామ్ యొక్క రోజులు లెక్కించబడ్డాయి.	Tom's days are numbered.
టామ్ నిన్న బిజీగా ఉన్నాడని నేను అనుకోను.	I don't think that Tom was busy yesterday.
దురదృష్టవశాత్తు, అది నిజం.	Unfortunately, that's true.
మేము ఏమి ఆలోచిస్తున్నాము?	What were we thinking?
మీరు ఎక్కడ ఉన్నారు?	Where are you located?
టామ్ అతను స్కూల్లో ఉన్నానని చెప్పాడు.	Tom told me that he was at school.
టామ్ ఈ మధ్యాహ్నం నన్ను పిలిచాడు.	Tom called me this afternoon.
మళ్ళీ అలా ప్రయత్నించండి.	Try doing that again.
నేను మేరీకి సహాయం చేయాల్సిన అవసరం ఉందని టామ్ భావిస్తాడు.	Tom thinks I need to help Mary.
ఇది అనివార్యం, కాదా?	It was inevitable, wasn't it?
టామ్ మేరీకి సహాయం చేయగలడని ఆశతో ఉన్నాడు.	Tom was hoping that he could help Mary.
టామ్ ఒక ఆదర్శప్రాయమైన పని చేస్తున్నాడు.	Tom is doing an exemplary job.
నేను సన్యాసిని.	I am a monk.
మీకు ఇప్పుడు ఇది అవసరమా?	Do you need it now?
టామ్ మనం ఏమి చేయాలనుకుంటున్నాడో అది చేద్దాం.	Let's do what Tom wants us to do.
టామ్ దాని గురించి ఏమి చెప్పబోతున్నాడు?	What's Tom going to say about that?
నేను నేలమాళిగలో ఉంటాను.	I'll be in the basement.
గుంటూరుకు గొప్ప సాంస్కృతిక వారసత్వం మరియు పురాతన కాలం నాటి సుదీర్ఘ చరిత్ర ఉంది.	Guntur has a rich cultural heritage and a long history dating back to the ancient times.
నేను విదేశీ కరెన్సీని ఎక్కడ మార్పిడి చేసుకోగలను?	Where can I exchange foreign currency?
టామ్ అధికారికంగా పదవీ విరమణ పొందారా?	Has Tom officially retired?
మీరు ఎర్ర మాంసం రోజుకు ఒకటి కంటే ఎక్కువసార్లు తినకూడదని విన్నాను.	I've heard that you shouldn't eat red meat more than once a day.
మీ భద్రత మా ఆందోళన కాదు.	Your safety isn't our concern.
టామ్ మేరీని లైఫ్ ప్రిజర్వర్‌గా విసిరాడు.	Tom threw Mary a life preserver.
నా డిప్లొమా రాకముందే నాన్న చనిపోయాడు.	My father died before I got my diploma.
టామ్ తన సూట్‌కేస్‌ను ప్యాక్ చేయడం ప్రారంభించాడు.	Tom started packing his suitcase.
టామ్ ఒక ప్రసిద్ధ గాయకుడికి పది వేల డాలర్లు ఇచ్చి హ్యాపీ బర్త్ డే పాడటానికి రెస్టారెంట్‌కు వచ్చాడు.	Tom gave a famous singer ten thousand dollars to come to the restaurant to sing Happy Birthday.
వేసవిని ఎక్కడ గడపాలని మీరు ప్లాన్ చేస్తున్నారు?	Where do you plan to spend the summer?
నేను నిజంగా దాని గురించి ఆలోచించడం ఇష్టం లేదు.	I don't really want to think about it.
స్థానిక ఇల్లు	Native house
టామ్ ఫ్రెంచ్‌లో నాకు హాయ్ చెప్పాడు.	Tom said hi to me in French.
నాకు డెజర్ట్‌లు తయారు చేయడం చాలా ఇష్టం.	I love making desserts.
టామ్ గత వారాంతంలో కాస్ట్యూమ్ పార్టీకి వెళ్ళాడు.	Tom went to a costume party last weekend.
టామ్ మరియు నేను భయపడము.	Tom and I aren't afraid.
మేఘావృతం, వర్షం, ఎండ	Cloudy, rainy,sunny
టామ్ అతను అక్కడికి ఎలా వెళ్ళాలో ప్లాన్ చేయలేదు.	Tom didn't say how he planned to get there.
టామ్ నాకు అసూయ ఉందని తెలుసు.	Tom knew I was jealous.
టీ చాలా రుచికరమైనది.	The tea is very tasty.
ఇక్కడ ఏదైనా పెరుగుతుందా అనేది సందేహమే.	It's doubtful that anything will grow here.
కంటికి పరిచయం చేయవద్దు.	Don't make eye contact.
అది నాకు కూడా జరగలేదు.	That didn't even occur to me.
కృష్ణుడు దుర్యోధనుడి క్రూరత్వం గురించి పాండవులకు చెప్పాడు.	Krishna tells the Pandavas about the cruelty of Duryodhana.
టామ్ మరియు మేరీ ఇద్దరూ సరైనవారు.	Tom and Mary are both right.
టామ్ భయంకరంగా కనిపిస్తాడు.	Tom looks dreadful.
బహుశా వారు వస్తారు మరియు వారు రాకపోవచ్చు.	Maybe they will come and maybe they won't.
నాకు కామెడీలు చాలా ఇష్టం.	I love comedies.
ఏమి జరిగిందో నేను నిజంగా క్షమించండి.	I'm really sorry about what happened.
అతను ఎప్పుడూ ముందు వరుసలో ఒక సీటు తీసుకున్నాడు.	He always took a seat in the front row.
టామ్‌కు ఇంకా నియమాలు తెలుసని నేను అనుకోను.	I don't think that Tom knows the rules yet.
దాని కోసం మేము ఎదురు చూస్తున్నాము.	That's what we're waiting for.
ఇంగ్లాండ్‌లో, వేసవిలో, ఉదయం 4 గంటలకు సూర్యుడు ఉదయిస్తాడు.	In England, in the summer, the sun rises at about 4 a.m.
మా ఇద్దరికీ కొంత బరువు తగ్గాలి.	Both of us should lose some weight.
నేను ఈ షెల్ఫ్‌లోని ప్రతి పుస్తకాన్ని చదివాను.	I've read every book on this shelf.
క్షమించండి, మీకు తప్పు సంఖ్య ఉంది.	I'm sorry, you have the wrong number.
మళ్ళీ తనిఖీ చేయండి.	Check it again.
ఆమె పోర్చుగల్‌లోని ఫ్రెంచ్ రాయబారి.	She's the French ambassador to Portugal.
ఈ రైఫిల్ యొక్క బారెల్ శుభ్రం చేయండి.	Clean the barrel of this rifle.
నాకు ఇప్పుడు చాలా కోపం ఉంది.	I'm very angry now.
టామ్ మా ప్రశ్నలకు సమాధానం ఇవ్వడానికి నిరాకరించాడు.	Tom refused to answer our questions.
నువ్వు పరిపూర్ణ స్నేహితురాలు.	You're the perfect girlfriend.
టామ్ తన ఇంటి పనికి నేను సహాయం చేయాలా?	Should I help Tom with his homework?
మీరు పాడతారా?	Will you sing?
నేను టామ్ లాగా ధైర్యంగా లేను.	I'm not as brave as Tom.
ఆ గదిని చిత్రించడానికి నాకు చాలా గంటలు పట్టింది.	It took me several hours to paint that room.
టామ్ డబ్బు జేబులో పెట్టుకున్నాడు.	Tom pocketed the money.
ఎవరూ ఎక్కడికి వెళ్ళడం లేదు.	Nobody's going anywhere.
నేను దానిని ఎలా చేయగలను?	How could I've let that happen?
దయచేసి నన్ను క్షేమించండి	please excuse me
స్వామి వివేకానంద గొప్ప భారతీయ సాధువు శిష్యుడు.	Swami Vivekananda was a disciple of the great Indian saint.
నన్ను క్షమించండి, కానీ మీరు కూర్చోవడానికి స్థలం ఉన్నందున మీరు కొంచెం ముందుకు వెళ్ళగలరా?	I'm sorry, but could you move over a bit so I have room to sit?
టామ్ తాను చేస్తానని వాగ్దానం చేసినట్లు చేశాడు.	Tom did what he promised he'd do.
టామ్ మా రక్షణకు వస్తున్నాడని నేను అనుకోను.	I don't think Tom is coming to our rescue.
మీరు ఎత్తులకు భయపడుతున్నారని నాకు తెలుసు.	I know you're afraid of heights.
భోజనాల గదికి రెండు తలుపులు ఉన్నాయి.	The dining room has two doors.
నా ఇల్లు పట్టణ శివార్లలో ఉంది.	My house is on the outskirts of town.
K. S. చిత్ర ఆరు జాతీయ చలనచిత్ర అవార్డులు, ఐదు ఫిల్మ్‌ఫేర్ అవార్డులు సౌత్ మరియు అనేక రాష్ట్ర ప్రభుత్వ అవార్డులతో సహా సంగీతానికి ఆమె చేసిన కృషికి అనేక అవార్డులను గెలుచుకుంది.	K. S. Chitra has won numerous awards for her contribution to music including six National Film Awards, five Filmfare Awards South, and several state government awards.
నేను తప్పనిసరిగా కొత్త జత బూట్లు కొనాలి.	I must buy a new pair of shoes.
మీరు ఎంత తరచుగా స్నానం చేస్తారు?	How often do you take a shower?
చాలా మంది పురుషులు కూడా సన్నగా ఉండాలని కోరుకుంటారు.	Many men want to be thin, too.
వారు ఎప్పుడైనా టామ్‌ను కనుగొన్నారా?	Did they ever find Tom?
అతనికి టయోటా ఉంది.	He has a Toyota.
సమావేశంలో మాట్లాడవద్దని ఆమెను కోరారు.	She was asked not to speak at the meeting.
మీ అందరికీ టామ్ తెలుసని నేను నమ్ముతున్నాను.	I believe you all know Tom.
టామ్ తనను తాను చంపేముందు మనం అతన్ని ఆపాలి.	We must stop Tom before he kills himself.
నాకు మరో బీర్ కావాలి.	I want another beer.
నేను చెప్పిన ప్రతిదానికీ క్షమాపణ చెప్పాలనుకుంటున్నాను.	I want to apologize for everything I said.
కొన్ని తేడాలు ఉన్నాయి.	There are some differences.
టామ్ ఇక్కడ లేడని వారు గమనించకపోవచ్చు.	They might not notice that Tom isn't here.
కొత్త టెలిస్కోప్ భారీ చెక్క పెట్టెలో రవాణా చేయబడింది.	The new telescope was shipped in a huge wooden box.
టామ్ తనకు చలిగా అనిపించింది.	Tom said that he felt cold.
టామ్ స్పష్టంగా భయపడ్డాడు.	Tom was obviously scared.
ఇది భయంకరమైనది.	It must've been terrible.
నేను వచ్చే ఏడాది తిరిగి రావాలనుకుంటున్నాను.	I want to come back next year.
మేరీ ధైర్యవంతురాలు.	Mary is a brave woman.
ఉదయం అంతా ఆకాశం బూడిద రంగులో ఉంది.	The sky was gray all morning.
నేను క్రిస్మస్‌ను ఎప్పుడూ ఇష్టపడలేదు.	I never liked Christmas.
నేను ఫ్రెంచ్ ఉపాధ్యాయుడిగా మారాలని ఆలోచిస్తున్నాను.	I'm considering becoming a French teacher.
మీరు అసూయపడతారని నాకు తెలియదు.	I didn't know you'd be jealous.
టామ్ పుస్తకం ఆసక్తికరంగా ఉందని నాకు చెప్పారు.	Tom told me the book was interesting.
తొమ్మిది తర్వాత కాల్ చేయడం చౌకైనదా?	Is it cheaper to call after nine?
టామ్ నాకు కావలసిన వస్తువులను కొంటాడు.	Tom buys me things that I want.
ఉపయోగించిన కారు కోసం నేను ఎక్కడ ప్రకటన చేయవచ్చు?	Where can I advertise for a used car?
ఈ జంట వారి నిశ్చితార్థాన్ని విరమించుకున్నారు.	The couple broke off their engagement.
నేను ఇతర మహిళలతో డేటింగ్ చేయాలనుకుంటున్నాను.	I want to date other women.
టామ్ తనను తొలగించారని చెప్పారు.	Tom says he was fired.
ఆమె అనారోగ్యంతో ఆరు వారాలపాటు ఆసుపత్రిలో ఉంది.	She was in the hospital for six weeks because she was sick.
దయచేసి అతని స్థితిలో ఏదైనా మార్పు గురించి నాకు తెలియజేయండి.	Please inform me of any change in his condition.
టామ్ పత్రాలపై సంతకం చేస్తున్నాడు.	Tom is signing documents.
నేను ఈ విషయంలో ఖచ్చితంగా ఉన్నాను.	I'm sure of this.
టామ్ మరియు మేరీ కలిసి ఉండాలని కోరుకున్నారు.	Tom and Mary wanted to be together.
బాలురు మరియు బాలికలు ఇద్దరూ పాఠశాలలో వంట తరగతి తీసుకోవాలి.	Both boys and girls should take cooking class in school.
ఇది ఎక్కడ ఉపయోగించబడింది?	Where's it used?
టామ్ కార్లను విక్రయిస్తాడు.	Tom sells cars.
ఆటోమొబైల్ ఆగిపోయింది.	The automobile stopped.
నిప్పుతో ఆడుకుంటున్నాడు	playing with fire
నా గడియారం వారానికి మూడు నిమిషాలు కోల్పోతుంది.	My watch loses three minutes a week.
మేము ఎందుకు వచ్చామో మీకు చెప్తాము.	Let us tell you why we came.
మీరు తెలుసుకోవాలనుకునే ప్రతిదీ మీకు చెప్తాను.	I'll tell you everything that you want to know.
సునీల్ తన తల్లిని ప్రేమిస్తాడు.	Sunil loves his mother.
అతను తనను ప్రేమిస్తున్నాడని అతను చెప్పాలని ఆమె కోరుకుంది.	She wanted him to say that he loved her.
ఆమె బిజీగా ఉంది.	She's busy.
అతను అబద్ధం చెప్పాడని నేను గట్టిగా అనుమానించాను.	I strongly suspected that he had been lying.
నా భార్యకు అలా చెప్పకండి.	Don't tell my wife that.
ఆమె మీ ఆరోగ్యం గురించి ఆత్రుతగా ఉంది.	She is anxious about your health.
టామ్ కొన్నిసార్లు నాతో అంగీకరిస్తాడు.	Tom sometimes agrees with me.
మీరు ఎప్పుడైనా మౌంట్ ఎక్కారా?	Have you ever climbed Mt. Fuji?
టామ్ మేరీ జాన్ సోదరి అని అనుకున్నాడు.	Tom thought that Mary was John's sister.
నేను మీ నుండి చాలా నేర్చుకున్నాను.	I've learned so much from you.
ఇది లేవడానికి సమయం.	It's time to get up.
టామ్ మరియు నేను ఇద్దరూ ఈ మధ్యాహ్నం బిజీగా ఉంటాము.	Both Tom and I'll be busy this afternoon.
మీరు ఛానల్ 1 లో ఇంగ్లీష్ మరియు ఛానల్ 7 లో జపనీస్ వినవచ్చు.	You can hear English on Channel 1, and Japanese on Channel 7.
ఇవి కొత్తవి.	These are the new ones.
నేను ఉద్యోగం కోసం చూస్తున్నాను.	I'm looking for a job.
టామ్ మాకు స్కీయింగ్ అంటే చాలా ఇష్టమని చెప్పాడు.	Tom told us he loved skiing.
అది అతని బలహీనమైన ప్రదేశం.	That's his weak spot.
మీకు దుప్పట్లు ఉన్నాయా?	Do you have blankets?
టామ్ ఈల వేయలేడు.	Tom can't whistle.
ఎవరూ ఏమీ అనలేదు.	Nobody said a thing.
నీ రోజు ఎలా గడుస్తోంది?	How's your day going?
ఎవరైనా తనను చంపాలని కోరుకుంటున్నారని టామ్ నమ్మలేకపోయాడు.	Tom couldn't believe that someone wanted to kill him.
నాకు భయంకరమైన చేతివ్రాత ఉంది.	I have terrible handwriting.
మీరు దానిని ద్వేషిస్తున్నారని నాకు తెలుసు.	I know you hate it.
నా ట్యాబ్‌లో ఉంచండి.	Put it on my tab.
మీ కెమెరా మరమ్మతులు ఎక్కడ పొందారు?	Where did you get your camera repaired?
ఇది పట్టింపు లేదని మీరు చెబుతున్నారా?	Are you saying this doesn't matter?
ఆమె హక్కైడోకు చెందినది, కానీ ఇప్పుడు టోక్యోలో నివసిస్తోంది.	She is from Hokkaido, but is now living in Tokyo.
నేను తెలుగు ఎలా నేర్చుకోవాలి?	How can I learn Telugu?
మీరు క్షమాపణ చెప్పాలి.	You've got to apologize.
మనం టాక్సీ తీసుకుందా?	Shall we take a taxi?
ప్రారంభించు	start
ఆ నిర్ణయం మనల్ని ఎలా ప్రభావితం చేస్తుంది?	How will that decision affect us?
నాకు ఏమి కావాలో నాకు తెలుసు.	I know what I want.
నేను ఒక వివరణాత్మక నివేదికను ఆశిస్తున్నాను.	I expect a detailed report.
సముద్రపు గల్లాలు తక్కువగా ఎగురుతున్నాయి.	The sea gulls are flying low.
గంగాధర్ కుటుంబంతో కలిసి ఉంటున్నాడు.	Gangadhar lives with his family.
మీరు మీ పని బాగా చేసారు.	You did your job well.
మేము అతన్ని ఆసుపత్రికి తీసుకువెళ్ళాము.	We took him to the hospital.
టామ్ ఎలా ఉంటాడో నాకు గుర్తులేదు.	I can't even remember what Tom looks like.
టామ్ నాకు పొరపాటు అని చెప్పాడు.	Tom told me I was mistaken.
నేను టామ్ కోసం టీ తయారు చేసాను.	I made tea for Tom.
నేను మీతో మాట్లాడకూడదని టామ్ చెప్పాడు.	Tom told me I shouldn't talk to you.
గురువు నల్లబల్లపై ఫ్రెంచ్ పదాలు రాశారు.	The teacher wrote French words on the blackboard.
మీ తల్లి ఇప్పుడు ఇంట్లో ఉందా?	Is your mother at home now?
వారంతా సమానం.	They're all equal.
టామ్ ఫ్రెంచ్ మాట్లాడటం ఎలా నేర్పించారు?	Who taught Tom how to speak French?
టామ్ మరియు మేరీ జాన్‌ను నమ్మారు.	Tom and Mary believed John.
మేరీ తనను నమ్మగలదని చెప్పే ఏకైక వ్యక్తి టామ్.	Tom is the only person Mary says she can trust.
ఇది పెద్దది కాదు.	It isn't big.
నేను టామ్‌కు ఏమీ చెప్పను.	I'm not going to tell Tom anything.
మీ సిగరెట్లు బయట పెట్టండి.	Put out your cigarettes.
టామ్ మీ కంటే తెలివిగా ఉన్నారా?	Is Tom smarter than you?
సరే, మనం ప్రారంభించవచ్చని అనుకుంటున్నాను.	OK, I think we can begin.
టామ్ అతను ఫ్రెంచ్ చదువుతున్నాడని మీకు చెప్పాడా?	Did Tom tell you he's studying French?
అది ఏమిటో మాకు చెప్పగలరా?	Can you tell us what it is?
వాషింగ్టన్ అమెరికాలో అత్యంత ప్రసిద్ధ వ్యక్తి.	Washington was the most famous man in America.
మేము దాని గురించి ఆందోళన చెందలేదు.	We're not worried about that at all.
మీరు చేయాల్సిందల్లా ఈ ఫారమ్ నింపండి.	All you have to do is fill in this form.
మేము ఉండి పోరాడతాము.	We'll stay and fight.
మిమ్మల్ని ఒప్పించటానికి నేను ఏమి చెప్పాలి?	What do I have to say to convince you?
మీరు ఎల్లప్పుడూ నాతో తిరిగి మాట్లాడతారు, లేదా?	You always talk back to me, don't you?
టామ్ తాను అలా చేయనని ప్రమాణం చేశాడు.	Tom swore he wouldn't do that.
నేను ప్రశాంతంగా ఉండటానికి ప్రయత్నిస్తున్నాను.	I'm trying to stay calm.
నేను ఈ రోజు టామ్‌తో కలిసి భోజనం చేశాను.	I had lunch with Tom today.
నిద్రోస్తుందా?	Are you sleepy?
నా సోదరులు ఇద్దరూ వివాహం చేసుకున్నారు.	Both of my brothers are married.
వారి ఇల్లు ఇక్కడ ఉంది.	Their house is near here.
టామ్ కి చెప్పండి నేను అతని చెట్లను కత్తిరించుకుంటాను.	Tell Tom that I'll prune his trees for him.
నేను ఎప్పుడూ ఆస్ట్రేలియాకు వెళ్ళలేదు.	I've never been to Australia.
నాకు చాలా మంది రోగులు లేరు.	I don't have a lot of patients.
మా తదుపరి సమావేశం అక్టోబర్ 20 న జరుగుతుంది.	Our next meeting will be held next on October 20th.
టామ్ మరణం నుండి ఇరుకైన తప్పించుకున్నాడు.	Tom had a narrow escape from death.
మీ పనిని కొనసాగించండి.	Carry on with your work.
టామ్ కొంచెం పాలు కొనడానికి ఇంటికి వెళ్ళేటప్పుడు సూపర్ మార్కెట్లోకి ప్రవేశించాడు.	Tom popped into the supermarket on his way home to buy some milk.
వారు సురక్షితంగా ఉన్నారని నేను అనుకోను.	I don't think they're safe.
ఆమె అతని చేతులను అతని మెడలో చుట్టింది.	She wrapped her arms around his neck.
ఆకలి	hungry
నేను టామ్‌ను ఎక్కడా కనుగొనలేను.	I can't find Tom anywhere.
మేరీ ఒక అందమైన అమ్మాయి, ఆమె కాదా?	Mary is a pretty girl, isn't she?
ధనవంతుడు	rich
మీరు అంత ఖచ్చితంగా ఉండలేరు.	You can't be so sure.
బీతొవెన్ యొక్క సింఫొనీల రికార్డింగ్‌ల పూర్తి సెట్ మాకు ఉంది.	We have a complete set of the recordings of Beethoven's symphonies.
వేసవి ఇప్పుడే ప్రారంభమైంది.	Summer has just begun.
మీరు బాగున్నారని వినడానికి నేను సంతోషిస్తున్నాను.	I'm glad to hear you're better.
నేను టామ్‌ను మేరీకి పరిచయం చేయాలనుకుంటున్నాను.	I'd like to introduce Tom to Mary.
టామ్ తన భార్యకు విధేయుడు.	Tom is loyal to his wife.
నాకు నోటీసు రాలేదు.	I didn't receive any notice.
మంచు కారణంగా పాఠశాల రద్దు చేయబడింది.	School was cancelled because of the snow.
మేము సోదరీమణులు అని దాదాపు ఎవరూ అనుకోరు.	Almost no one thinks that we are sisters.
నేను జర్మన్ మాట్లాడేటప్పుడు వారు నన్ను అర్థం చేసుకోరు.	They don't understand me when I speak German.
టామ్ తన టికెట్ కోసం మేరీని మోసగించాడు.	Tom tricked Mary into paying for his ticket.
ఈ విషయాలన్నీ మీకు ఎక్కడ లభించాయి?	Where did you get all this stuff?
మీరు ఈ మాన్యుస్క్రిప్ట్‌ను ఫ్రెంచ్ నుండి ఇంగ్లీషులోకి అనువదించగలరా?	Can you translate this manuscript from French to English?
టామ్ ఈ రోజు బోస్టన్‌కు వెళ్లాడు.	Tom flew to Boston today.
గొప్ప సినిమా	great movie
టామ్ దయగల హృదయాన్ని కలిగి ఉన్నాడు.	Tom has a kind heart.
నేను చేయమని చెప్పినట్లు వారు చేస్తారు.	They'll do what I tell them to do.
టామ్ నన్ను చూడటం సంతోషంగా అనిపించలేదు.	Tom didn't seem happy to see me.
ఇక్కడికి రండి.	Come here.
టామ్ మరియు మేరీ దగ్గరి బంధువులు.	Tom and Mary are close relatives.
టామ్ మేరీ మరియు నేను మనమే చేయాలని కోరుకుంటున్నాను.	Tom wants Mary and I to do that by ourselves.
నేను ఈ రోజు ఆసక్తికరమైన విషయం కనుగొన్నాను.	I found out something interesting today.
టామ్ పియానోను బాగా వాయించాడు.	Tom plays the piano very well.
టామ్ నగర జీవితానికి అలవాటుపడలేదు.	Tom isn't used to city life.
మేము కలిసి పిల్లలు.	We were kids together.
టామ్ నాకన్నా మంచి గాయకుడు.	Tom is a much better singer than I am.
నన్ను తారుమారు చేయవద్దు	don't manipulate me
టామ్ డ్రైయర్‌ను స్విచ్ ఆఫ్ చేశాడు.	Tom switched off the dryer.
మీరిద్దరూ వెళ్ళవచ్చు.	You two may leave.
టామ్ తాను నడవలేనని చెప్పాడు.	Tom said he couldn't walk.
నా స్థానంలో మీరు ఏమి చేస్తారు?	What would you do in my position?
నా లైబ్రరీలోని ఏదైనా పుస్తకానికి మీకు స్వాగతం.	You're welcome to any book in my library.
సంస్కృతం భారతీయ ఉపఖండంలో ఉద్భవించిన ప్రాచీన భాష.	Sanskrit is an ancient language that originated in the Indian subcontinent.
వారు కూర్చున్నారు.	They sat down.
మీ కారు నల్లగా ఉందా?	Is your car black?
టామ్ పదమూడు సంవత్సరాలు, కానీ అతను ఇప్పటికీ శాంటాను నమ్ముతాడు.	Tom is thirteen, but he still believes in Santa.
మీరు సరైనవారని మేము భావిస్తున్నాము.	We think you're right.
వారు మౌనంగా ఉన్నారు.	They were silent.
మనమే	ourself
టామ్ చూశానని మీరు అనుకుంటున్నారా?	Do you think Tom saw it?
ఈ వంటకం చాలా కారంగా ఉంటుంది.	This dish is too spicy.
త్వరగా	quickly
టెలివిజన్ లేకుండా జీవితం ఎలా ఉంటుందో మీరు Can హించగలరా?	Can you imagine what life would be like without television?
చెన్నైకి చెందిన క్రికెట్ ప్లేయర్	Cricket player from Chennai
టామ్ పిల్లలను మంచానికి పెట్టాడు.	Tom put the kids to bed.
నాకు ట్విట్టర్ ఖాతా లేదు.	I don't have a Twitter account.
టామ్ మేరీకి కొన్ని తెలివితక్కువ ప్రశ్నలను అడిగారు.	Tom asked Mary some stupid questions that she refused to answer.
మర్చిపోయాను	forgot
దేవాలయం అనేది ఆధ్యాత్మిక ఆచారాలు మరియు ప్రార్థన మరియు త్యాగం వంటి కార్యకలాపాల కోసం ప్రత్యేకించబడిన భవనం.	A temple is a building reserved for spiritual rituals and activities such as prayer and sacrifice.
అతను తన తప్పును అంగీకరించడం లేదు.	He was not about to admit his mistake.
నెమ్మదిగా	slowly
నేను నిన్ను ప్రేమిస్తున్నానని నీకు తెలుసు!	You know I love you!
మీకు జలుబు ఉండవచ్చు.	You probably just have a cold.
టామ్ నన్ను అలా చేయాలని ఎందుకు అనుకున్నాడు?	Why do you think Tom wanted me to do that?
ఈ యంత్రం సరిగ్గా ఏమి చేస్తుంది?	What does this machine do exactly?
తండ్రి	Father
నా వైపు నొప్పి వచ్చింది.	I've got a pain in my side.
టామ్ తన చొక్కాను హ్యాంగర్ మీద ఉంచాడు.	Tom put his shirt on a hanger.
టామ్ వేచి ఉండాల్సిన అవసరం లేదు.	Tom didn't need to wait.
బహుశా నేను అలా చేయకూడదు.	Maybe I shouldn't have done that.
నా అత్తకు ముగ్గురు పిల్లలు ఉన్నారు.	My aunt had three kids.
టామ్ మార్పును గమనించలేదు.	Tom didn't notice the change.
నాకు మృదువైన గొరుగుట వచ్చింది.	I got a smooth shave.
నేను ఇప్పుడు జీవితాన్ని భిన్నంగా చూస్తున్నాను.	I see life differently now.
అతను చాలా సంతోషంగా ఉన్నాడు.	He feels very happy.
టామ్ అంత తెలివితక్కువవాడు కాకపోతే, అతను త్వరగా అర్థం చేసుకున్నాడు.	If Tom wasn't so stupid, he would've understood quicker.
నేను దాదాపు ప్రతిరోజూ గూగుల్‌ని ఉపయోగిస్తాను.	I use Google almost every day.
తనకు విశ్రాంతి అవసరమని టామ్ చెప్పాడు.	Tom said that he needed a rest.
పోలీసులు దీనిని ఆపలేరు.	The police can't stop this.
ఈ పెట్టె ఖాళీగా ఉంది.	This box is empty. It has nothing in it.
నేను మీ గురించి కలలు కంటున్నాను.	I'll dream about you.
మీకు మరియు టామ్‌కు మంచి సమయం లభిస్తుందని నేను ఆశిస్తున్నాను.	I hope you and Tom will have a good time.
టామ్ తన ఎడమ కన్ను నుండి బాగా చూడలేడు అనేది నిజమేనా?	Is it true that Tom can't see very well out of his left eye?
అతనికి నీడ.	Shadow him.
నేను అతని ఆలోచనలకు మద్దతు ఇవ్వను.	I don't support his ideas.
నేను దంతవైద్యుని వద్దకు వెళ్లాను.	I've been to the dentist's.
అంతా(ప్రతిదీ)	Everything
మిమ్మల్ని కలవడం నాకు చాలా సంతోషంగా ఉంది	I am very happy to meet you
మేము టామ్ కోసం వేచి ఉండాలి.	We should wait for Tom.
టామ్ డాల్ఫిన్లతో ఈదుకున్నాడు.	Tom swam with the dolphins.
టామ్ యొక్క ఆపుకోలేనిది.	Tom's unstoppable.
ఎక్కడ	Where
మీరు నాకు ఏమి చేశారో చూడండి.	Look what you've done to me.
నేను తగినంత విజయవంతమయ్యానని నేను అనుకోను.	I just don't think I'm successful enough.
టామ్ మేరీకి నిజం చెప్పమని చెప్పాడు.	Tom told Mary to tell the truth.
నేను టామ్ కోసం చూస్తున్నాను.	I've been looking for Tom.
టామ్ తన సోదరికి కేక్ ముక్కను కత్తిరించాడు.	Tom cut his sister a piece of cake.
మీరు చేసిన పనికి నేను నిన్ను గౌరవిస్తాను.	I respect you for what you have done.
నెల్లూరు నుంచి వేలూరు వెళ్తున్నారు.	Going to Nellore to Vellore.
టామ్ సరదాగా లేడు.	Tom isn't having fun.
నేను అలా చేయటానికి బలంగా లేను.	I'm not strong enough to do that.
నేను టామ్ గురించి ఫ్రెంచ్ మాట్లాడతాను.	I think I speak French about as well as Tom does.
ఒకటి ఎంచుకోండి.	Choose one.
టామ్ మేరీ కంటే ఫ్రెంచ్ బాగా మాట్లాడతాడు.	Tom speaks French better than Mary does.
నేను టామ్‌ను ఆకట్టుకున్నాను.	I don't think I impressed Tom.
టామ్ ఒంటరిగా బార్ వద్ద కూర్చుని, వైన్ తాగడం చూశాను.	I saw Tom sitting at the bar alone, drinking wine.
మీరు నన్ను తప్పించుకుంటున్నారు.	You're avoiding me.
టామ్‌కు నిజంగా స్నేహితురాలు ఉందా?	Does Tom really have a girlfriend?
నేను దాని గురించి మరచిపోయాను.	I'd forgotten about that.
రేపు వాతావరణం బాగుంటే, మాకు పిక్నిక్ ఉంటుంది.	If the weather is nice tomorrow, we will have a picnic.
నేను ఎప్పుడూ చుట్టూ ఉండను.	I won't always be around.
ఇది మీరు అయి ఉండాలి.	It had to be you.
నేను నా సమయాన్ని వృధా చేస్తున్నాను.	I'm wasting my time.
నేను రెండు గంటలు మాత్రమే పడుకున్నాను.	I slept only two hours.
అమ్మా	Mother
అతను పొరపాటున తన కప్పు కాఫీలో ఉప్పు వేశాడు.	He put salt into his cup of coffee by mistake.
మనమందరం ఇష్టపడాలని కోరుకుంటున్నాము.	We all want to be liked.
టామ్ యొక్క దుష్ట.	Tom's wicked.
శిక్ష అనుభవించిన వ్యక్తి టామ్.	Tom was the one who got punished.
మీ సోదరుడు ఎక్కడ?	Where is your brother?
మీరు టామ్‌తో చాలా సమయం గడిపారు?	Have you spent a lot of time with Tom?
నేను నా పాస్వర్డ్ను మర్చిపోయాను.	I forgot my password.
నేను అహ్మదాబాద్ నుండి వస్తున్నాను	I am coming from Ahmedabad
ఇది చాలా బాధాకరమైనది.	It's too painful.
మనకు ఎందుకు విందు లేదు?	Why don't we have dinner?
స్వస్థలము	Native place
టామ్ బాగానే ఉన్నాడు.	Tom has been managing just fine.
నేను దీన్ని మీకు అనుమతించలేను.	I can't let you do this.
అమ్మ దాని గురించి ప్రస్తావించలేదు.	Mom did not mention it.
మీరు ఈ బ్యాగ్ నాకు చూపించగలరా?	Could you show me this bag?
ఎవరో తెల్ల జెండా aving పుతూ నేను చూస్తున్నాను.	I see someone waving a white flag.
మీరు ఈ జంతువును ఫ్రెంచ్ భాషలో ఏమని పిలుస్తారు?	What do you call this animal in French?
టామ్ ధూమపానం మానేయాలని అనుకున్నాడు.	Tom wanted to quit smoking.
సోదరుడు	Brother
టామ్ అతను వేచి ఉంటానని చెప్పాడు.	Tom said he'll wait.
మీరు అలాంటి అలవాటును వదిలించుకోవాలి.	You must get rid of such a habit.
టామ్‌కు సహాయం చేయడానికి మేము వెనుక ఉండిపోయాము.	We stayed behind to help Tom.
చత్రపతి శివాజీ 17వ మరియు 18వ శతాబ్దాలలో భారతదేశంలోని అత్యంత శక్తివంతమైన సామ్రాజ్యాలలో ఒకటి.	Chatrapati shivaji one of the most powerful empires in India during the 17th and 18th centuries.
మేరీ తన డబ్బును తిరిగి డిమాండ్ చేసింది.	Mary demanded her money back.
అతను నిగ్రహాన్ని కోల్పోయాడు మరియు నాపై అరిచాడు.	He lost his temper and shouted at me.
ఈ రోజు పని చేయాలని నాకు అనిపించదు.	I don't feel like working today.
టామ్ ఈ రోజు మాకు సహాయం చేయలేడు.	Tom can't help us today.
టామ్ తాను బిజీగా ఉన్నానని చెప్పాడు.	Tom said that he had been busy.
నేను విసుగు చెందుతున్నాను.	I'm getting bored.
టామ్ మాకు శబ్దం చేయవద్దని కోరాడు.	Tom asked us not to make any noise.
ఇది ఏదో ఒక రోజు జరుగుతుందని నాకు తెలుసు.	I've always known that this would happen someday.
నేను ముద్దు పెట్టుకున్న మొదటి అమ్మాయి మేరీ.	The first girl I ever kissed was Mary.
నేను ఇప్పటికీ నిన్ను చాలా ప్రేమిస్తున్నాను.	I still love you very much.
నేను ధనవంతుడిని అని కోరుకుంటున్నాను.	I wish I were rich.
టామ్ ఇప్పుడు అలా చేస్తున్నట్లు అనిపించదు.	Tom doesn't feel like doing that now.
తెలుగు నుండి హిందీకి అనువాదం	Telugu to hindi translation
గత సంవత్సరం మీరు మీ తాతామామలను ఎన్నిసార్లు సందర్శించారు?	How many times did you visit your grandparents last year?
ఇది తీవ్రంగా లేదు.	It's not serious.
వేలాది గృహాలు ధ్వంసమయ్యాయి.	Thousands of homes were destroyed.
నేను ముందు తలుపు లాక్ చేయడం మర్చిపోయాను.	I forgot to lock the front door.
ఒక మైలు 1,600 మీటర్లు.	A mile is about 1,600 meters.
పర్యాటకుడిలా దుస్తులు ధరించవద్దు.	Don't dress like a tourist.
మీకు అది ఎలా ఇష్టం?	How do you like that?
వారు హోటల్ వద్దకు వచ్చారు.	They arrived at the hotel.
టామ్, మీరు ఎందుకు వెళ్లరు?	Why don't you leave, Tom?
ఆశాజనక, మేము ఈ రోజు టామ్‌ను చూస్తాము.	Hopefully, we'll see Tom today.
టామ్ తన ఇంట్లో ఒక రహస్య గది ఉంది.	Tom has a secret room in his house.
ఇవి మీవి కాదా?	These aren't yours, are they?
కొంతమంది కుర్రాళ్ళు తరగతి గదిలోకి వచ్చారు.	Some boys came into the classroom.
టామ్ ఓడిపోయాడు.	Tom was defeated.
లతా మంగేష్కర్ ఒక పురాణ భారతీయ నేపథ్య గాయని, ఆమె వెయ్యికి పైగా హిందీ చిత్రాలలో, అలాగే అనేక ఇతర భారతీయ మరియు విదేశీ భాషలలో పాడింది.	Lata Mangeshkar is a legendary Indian playback singer who has sung in over a thousand Hindi films, as well as in various other Indian and foreign languages.
అందరూ కొలనులోకి దూకేశారు.	Everybody jumped into the pool.
సాయికి మంచి అనుభూతి కలుగుతోంది	Sai is feeling good
ఇప్పుడు మీకు ఎలా అనిపిస్తుంది?	How do you feel now?
జాన్ జాన్‌తో విడిపోయినప్పటి నుండి మేరీకి నిజంగా ఆసక్తి ఉన్న మొదటి వ్యక్తి టామ్.	Tom is the first guy Mary has really been interested in since she broke up with John.
టామ్ విద్యార్థి కాదు.	Tom isn't a student.
మేరీ ఎంత అనారోగ్యంతో ఉన్నారో టామ్‌కు తెలియదు.	Tom doesn't know how sick Mary is.
మీ నోటితో పూర్తిగా మాట్లాడకండి.	Don't talk with your mouth full.
నేను నా జుట్టు కడగాలి.	I want to wash my hair.
నాకు వార్తాపత్రిక తీసుకురండి.	Bring me the newspaper.
దిశలు	Directions
ఫలితం అతన్ని సంతృప్తిపరుస్తుంది.	The result will satisfy him.
మీరు ఎరుపు రంగులోకి మారుతున్నారు.	You're turning red.
S. P. బాలసుబ్రహ్మణ్యం, ప్రముఖ భారతీయ నేపథ్య గాయకుడు మరియు సంగీత స్వరకర్త, అతను ప్రధానంగా తమిళం, తెలుగు, కన్నడ, హిందీ మరియు మలయాళ చిత్ర పరిశ్రమలలో పనిచేశాడు.	S. P. Balasubrahmanyam, was a legendary Indian playback singer and music composer who primarily worked in the Tamil, Telugu, Kannada, Hindi, and Malayalam film industries.
పేరు	name
నేను చిన్నతనంలో చేపలు తినలేను.	I couldn't eat fish when I was a child.
బేసి, కాదా?	Odd, isn't it? We should have already arrived.
ఎవరికీ ఆకలి లేదు.	No one's hungry.
మీకు ఇష్టమైన పియానిస్ట్ ఎవరు?	Who is your favorite pianist?
టామ్ మరియు నేను అలా చేయాల్సిన అవసరం ఉందని మీకు తెలియదా?	Didn't you know that Tom and I needed to do that?
ఇది పొరపాటు.	It's likely a mistake.
ఓడలో ఎంత మంది ఉన్నారు?	How many people are on board the ship?
ఆమె ముప్పై మూడు.	She's thirty-three.
వర్క్‌షాప్‌లో మూడు ప్రింటింగ్ ప్రెస్‌లు ఉన్నాయి.	There are three printing presses in the workshop.
ఐదు భాషలు మాట్లాడే ఎవరైనా మీకు తెలుసా?	Do you know anybody who speaks five languages?
నేను అలా చేశానని ఎవరికీ చెప్పవద్దు.	Please don't tell anyone I did that.
నేను అతని పక్కన కూర్చున్నాను.	I sat down next to him.
ముగింపు	end
నెల్లూరుకు గొప్ప చరిత్ర మరియు సాంస్కృతిక వారసత్వం ఉంది, అనేక చారిత్రక ప్రదేశాలు మరియు దేవాలయాలు ప్రపంచం నలుమూలల నుండి పర్యాటకులను ఆకర్షిస్తాయి.	Nellore has a rich history and cultural heritage, with several historical landmarks and temples that attract tourists from all over the world.
టామ్ నా మామయ్య కాదు.	Tom isn't my uncle.
నేను పదకొండవ తరగతిలో ఉన్నాను.	I'm in the eleventh grade.
కంప్యూటర్ విరిగిపోయింది.	The computer is broken.
నాకు జోక్ రాలేదు.	I didn't get the joke.
చాలా చల్లగా ఉన్నందున నేను ఈత కొట్టలేదు.	I didn't swim because it was too cold.
నేను ఇంత సంతోషంగా ఉన్నానని నేను అనుకోను.	I don't think I've ever been this happy.
క్రీడలు	sports
నేను ఏమి మాట్లాడుతున్నానో మీకు తెలుసని అనుకుంటున్నాను.	I think you know what I'm talking about.
టామ్ ఖరీదైన సూట్ ధరించి ఉన్నాడు.	Tom is wearing an expensive suit.
నగరంలో దక్షిణ మధ్య రైల్వే నెట్‌వర్క్‌లో భాగమైన రైల్వే స్టేషన్ ఉంది.	The city has a railway station that is part of the South Central Railway network.
టామ్ మరియు నేను ఇద్దరూ ఆస్ట్రేలియాలో నివసిస్తున్నాము మరియు పని చేస్తున్నాము.	Tom and I both live and work in Australia.
తలుపు తెరిచి ఉంచకూడదు.	The door must not be left open.
టామ్ మా పెంపుడు కొడుకు.	Tom is our foster son.
నేను టామ్‌తో చాలా కాలం మాట్లాడలేదు.	I haven't talked to Tom in a very long time.
టామ్ వయసు 13, కానీ అతను ఇప్పటికీ శాంటాను నమ్ముతాడు.	Tom is 13, but he still believes in Santa.
టామ్ తన గదిని ఇంకా శుభ్రం చేశాడా?	Has Tom cleaned his room yet?
టామ్‌ను ఇక్కడికి రానివ్వమని హెచ్చరించాను.	I warned Tom not to come here.
ఈ ఆలయం నెల్లూరులోని పురాతన మరియు ప్రముఖ దేవాలయాలలో ఒకటి.	The temple is one of the oldest and most prominent temples in Nellore.
నేను చిన్నపిల్లలా వ్యవహరించడం ఇష్టం లేదు.	I don't like being treated like a child.
ఆ టామ్ మీరు ఇప్పుడే మాట్లాడుతున్నారా?	Was that Tom you were just talking to?
నేను అలా చేయనందుకు చాలా సంతోషంగా ఉంది.	I'm very glad that I didn't do that.
మీరు రేపు రోజంతా చదువుతారని అనుకుందాం.	I suppose you'll be studying all day tomorrow.
నేను నిజంగా నిరాశకు గురయ్యాను.	I was really depressed.
నేను నిద్రించటానికి వెళుతున్నాను	i am going to sleep
టామ్ తనకన్నా చాలా చిన్న అమ్మాయిని వివాహం చేసుకున్నాడు.	Tom married a girl much younger than himself.
టామ్ మేరీ తల కత్తిరించాడు.	Tom cut off Mary's head.
మీకు పియానో ఉందా?	Do you have a piano?
నేను పాడటానికి వెళ్ళడం లేదు.	I'm not going to sing.
నాకు ఒక అవసరం లేదు.	I have an excuse.
పోలీసులు ఈ స్థలం యొక్క ప్రతి అంగుళం మీదుగా వెళ్లారు.	The police went over every inch of this place.
టామ్ యొక్క ఖాళీ ప్లేట్ తీసివేయడానికి వెయిటర్ వచ్చాడు.	The waiter came over to take away Tom's empty plate.
గత నెలలో మీ వేతనాలు ఇక్కడ ఉన్నాయి.	Here are your wages for the last month.
నేను బడికి పరిగెత్తాను.	I ran to school.
నేను అంగీకరిస్తున్నాను, నేను ప్రపంచంలో చక్కని వ్యక్తిని కాదు.	I admit, I'm not the tidiest person in the world.
ఏమి ఆశించాలో మాకు తెలుసు.	We know what to expect.
మేరీ మేల్కొని ఉన్నాడని టామ్ కి తెలుసు.	Tom knew that Mary was awake.
మేరీ అక్కడ ఉన్నట్లు టామ్ గమనించాడు.	Tom noticed Mary was there.
మేము ప్రతి ఒక్కరినీ వదిలి వెళ్ళమని చెప్పాల్సి ఉంది.	We were supposed to tell everyone to leave.
అతను తన నాలుకతో ముక్కును తాకగలడు.	He can touch his nose with his tongue.
ఇది చాలా కష్టం కాదు.	It's not too hard.
టామ్ నన్ను డ్రైవ్ చేయాలనుకున్నాడు.	Tom wanted me to drive.
ప్రతి నదికి ఒక వంతెన ఉండేది.	There was a bridge across each river.
టామ్ నా ముగ్గురు పిల్లలలో చిన్నవాడు.	Tom is the youngest of my three children.
లైబ్రేరియన్ చాలా అనారోగ్యంగా కనిపించాడు.	The librarian looked quite sick.
నేను నిజంగా టామ్‌తో చేపలు పట్టడానికి ఇష్టపడను.	I don't really want to go fishing with Tom.
ఇక్కడ వారు సాధారణంగా విందు చేస్తారు.	Here's where they usually have dinner.
టామ్ అతని ఛాతీ వైపు చూపించాడు.	Tom pointed to his chest.
టామ్ బస్సు డ్రైవర్ కాదు, అవునా?	Tom isn't a bus driver, is he?
నాకు సమయం లేదు.	I have no time left.
టామ్ మేరీకి నిద్రవేళ కథ చదివాడు.	Tom read Mary a bedtime story.
మీరు నా ప్రేరణ.	You were my inspiration.
టామ్ గురించి నాకు వార్తలు ఉన్నాయి.	I have news about Tom.
టామ్ సమీపంలోని రెస్టారెంట్‌లో పనిచేస్తాడు.	Tom works at a nearby restaurant.
టామ్ సమాధానం చెప్పలేడు.	Tom can't answer.
సమస్య గురించి ఆమె వివరణ అర్ధంలేనిది.	Her explanation of the problem was nonsense.
నేను దేనికైనా సిద్ధంగా ఉండాలనుకుంటున్నాను.	I want to be ready for anything.
మీరు పట్టికను క్లియర్ చేయాలి.	You must clear the table.
మేము ఇప్పుడు ఈ సంవత్సరం వ్యాపార ఫలితాలపై నివేదిస్తాము.	We will now report on this year's business results.
నేను టామ్ యొక్క మెదడులను కలిగి ఉండాలని కోరుకుంటున్నాను.	I wish I had Tom's brains.
టామ్ ఎక్కడికి వెళ్ళలేదు.	Tom has got nowhere to go.
మనమందరం ఇంతకు ముందు చూశాము.	We've all seen that before.
టామ్ విసుగు చెందినట్లుంది.	Tom seems bored.
నేనే ప్రవర్తించాను.	I behaved myself.
మా కొడుకు యుద్ధంలో చంపబడ్డాడు.	Our son was killed in the war.
టామ్ ఎప్పుడూ పెళ్లి చేసుకోబోతున్నాడని నేను అనుకోను.	I don't think that Tom is ever going to get married.
మీ అన్ని ఫైల్‌లను బ్యాకప్ చేయాలని నిర్ధారించుకోండి.	Make sure to back up all your files.
టామ్ సంతోషంగా ఉంటే, నేను సంతోషంగా ఉన్నాను.	If Tom is happy, I'm happy.
నేను తదుపరిసారి ఆట గెలవను.	I will win the game next time.
నేను సంవత్సరాలలో చాలా ఆనందించలేదు.	I haven't had this much fun in years.
ఆ ఫలితం able హించదగినది.	That result was predictable.
మేము ఏమీ చేయడం లేదు.	We aren't doing anything.
మేము వస్తున్నాము.	We're coming.
అధికారిక సమాచారం	Official Information
నేను విమానాశ్రయానికి వచ్చిన వెంటనే మీకు ఫోన్ చేస్తాను.	I'll phone you as soon as I get to the airport.
నేను టామ్‌ను పోలీసుల వద్దకు వెళ్ళమని చెప్పాను.	I told Tom to go to the police.
టామ్ వారి నాయకుడు.	Tom is their leader.
టామ్ మరియు మేరీ వివాహం చేసుకున్నారని నేను అనుకున్నాను.	I thought Tom and Mary were married.
ఇది చాలా అద్భుతంగా ఉంది.	It's pretty amazing.
టామ్ యాక్షన్ సినిమాలు చూడటం ఇష్టపడతాడు.	Tom likes watching action movies.
టామ్ మేరీ చాలా బరువుగా ఉన్నాడు.	Tom said Mary was quite heavy.
శబ్దం వినబడలేదు.	Not a sound was heard.
టామ్ మేరీని సమ్మర్ క్యాంప్‌కు పంపాడు.	Tom sent Mary to summer camp.
ఇది అమ్మకానికి లేదు.	This isn't for sale.
నీకు పుట్టిన రోజు శుభాకాంక్షలు.	Happy Birthday to you.
నాకు సినిమా నిజంగా నచ్చింది.	I really liked the movie.
టామ్‌కు నిజం చెప్పే సమయం ఆసన్నమైందని నేను భావిస్తున్నాను.	I think that it's time for us to tell Tom the truth.
సమస్యకు సులభమైన పరిష్కారం బహుశా ఉంది.	There is probably an easy solution to the problem.
టామ్ కెరీర్ ముగిసింది.	Tom's career is over.
ఇంటికి వెళ్ళేటప్పుడు నేను కనుగొన్నదాన్ని చూడండి.	Look what I found on my way home.
ఇది దాదాపు తెల్లవారుజాము మరియు ఇంకా ఏమీ జరగలేదు.	It's almost dawn and nothing's happened yet.
నాకు అబ్బాయి తెలుసు.	I know the boy.
టామ్ పోయిందని అనుకుంటున్నాను.	I think Tom is gone.
టామ్ చెప్పినట్లు చెప్పినట్లు నేను ప్రతిదీ చేసాను.	I did everything the way Tom told me to do it.
పోలీసులు వారి ఆయుధాలను తగ్గించారు.	The police lowered their weapons.
దాన్ని మరచిపోదాం.	Let's forget it.
చెడు కొన్నిసార్లు గెలుస్తుంది.	Evil sometimes wins.
టామ్ కాలేజీ ఆవరణలో నడుస్తున్నాడు.	Tom is walking in college premises.
ముప్పై ఏళ్ళలో మనకు ఉన్న హాటెస్ట్ వేసవి ఇది.	This is the hottest summer that we have had in thirty years.
టామ్ సరిగ్గా ఎక్కడ నివసిస్తాడు?	Where exactly does Tom live?
టామ్ నాకు భయపడ్డాడని చెప్పాడు.	Tom told me you were afraid.
నేను ఇంతకు ముందు మిమ్మల్ని ఇంత భయంతో చూడలేదు.	I'd never seen you so afraid before.
మాకు మూడు కప్పులు అవసరం.	We need three cups.
మీరు తప్పక ప్రయత్నించాలి మరియు పార్టీకి రావాలి.	You must try and come to the party.
ఇది ఒక భ్రమ.	It's an illusion.
నేను అతని జోకులు చాలా ఉన్నాయి.	I have had quite enough of his jokes.
బహుశా వారు చెప్పేది అదే.	That's probably what they'll say.
దయచేసి ఏమి జరిగిందో మాకు చెప్పండి.	Please tell us what happened.
నేను అతని కోసం రేడియోను పరిష్కరించాను.	I've fixed the radio for him.
నన్ను నేను ద్వేషిస్తున్నాను.	I hate myself.
నేను మీకు సహాయం చేయలేను.	I cannot possibly help you.
టామ్ రేడియోను తిరస్కరించాడు.	Tom turned down the radio.
మీరు దానిని మీతో తీసుకోలేరు.	You can't take it with you.
ఆ తర్వాత పరిస్థితులు మారిపోయాయి.	Things changed after that.
మేము మా ఇంటిని అమ్మకానికి పెట్టడం గురించి ఆలోచిస్తున్నాము.	We're thinking about putting our house up for sale.
విరామ సమయంలో, నేను లాబీలో టామ్ కోసం వెతకడానికి వెళ్ళాను.	During the break, I went to look for Tom in the lobby.
నేను ఎప్పుడూ అలా చేయమని మిమ్మల్ని అడగలేదు.	I never asked you to do that.
పాఠశాల ఏప్రిల్‌లో ప్రారంభమవుతుంది.	School begins in April.
టామ్ నా ఫోన్ నంబర్ అడిగారు.	Tom asked me for my phone number.
టామ్ వారాంతం వరకు వేచి ఉండలేకపోయాడు.	Tom couldn't wait until the weekend.
ఇసాబెలా మరణించాడని వారు అంటున్నారు.	They say that Isabela died.
నేను గత రాత్రి నిద్రపోలేను, కాబట్టి నేను హర్రర్ సినిమా చూడాలని నిర్ణయించుకున్నాను.	I couldn't sleep last night, so I decided to watch a horror movie.
కస్టమర్ అంగీకరిస్తాడు.	The customer agrees.
నేను చాలా బద్ధకంగా ఉన్నాను.	I'm quite lazy.
అతను త్వరలో తిరిగి వస్తాడు.	He will be back soon.
టామ్ దీన్ని చదవాలని నేను కోరుకుంటున్నాను.	I want Tom to read this.
దయచేసి దీన్ని ఎలా చేయాలో నాకు చూపించండి.	Please show me how to do that.
టామ్ చేసినది అదే.	That's precisely what Tom did.
టామ్‌కు చెవి ఉంది.	Tom has an earache.
నాకు మలయాళం రాదు.	I don't know Malayalam.
నా దగ్గర డబ్బు లేదు.	I have no money with me.
ఇది ఒక అభిరుచిగా ప్రారంభమైంది.	It started as a hobby.
కొంతమంది హాంగ్ గ్లైడింగ్ ప్రమాదకరమైన క్రీడ అని భావిస్తారు.	Some people think that hang gliding is a dangerous sport.
వారు నన్ను చంపుతారు.	They'll kill me.
మీకు అన్యాయంగా ప్రవర్తించారు.	You were treated unfairly.
ఆ రాత్రి వింతైన విషయాలు జరిగాయి.	Strange things happened that night.
టామ్ మిమ్మల్ని కోల్పోతాడు.	Tom is going to miss you.
ఆ నటి ఎప్పటిలాగే అందంగా ఉంది.	That actress is as beautiful as ever.
నేను ఇప్పుడు మీకు సహాయం చేయగలను.	I can help you now.
ప్లాంక్ నేలమీద గడ్డకట్టింది.	The plank froze to the ground.
టామ్ తన గందరగోళాన్ని దాచడానికి ప్రయత్నించాడు.	Tom tried to hide his confusion.
ఎందుకు చాలా నెమ్మదిగా నడుస్తున్నాయి?	Why are running very slowly?
టామ్ అతను ఎప్పుడూ సరైనవాడు అని అనుకుంటాడు.	Tom thinks that he's always right.
భయపడవద్దు!	Don't panic!
పిల్లి పెట్టెలో ఉంది.	The cat is in the box.
అతను ఫ్రెంచ్ బోధించే సామర్థ్యం కలిగి ఉంటాడు.	He is capable of teaching French.
నేను ఏమి జరిగిందో విన్నాను.	I heard about what happened.
నేను మీకు చెప్పలేను.	That I can't tell you.
టామ్ మేరీకి అర మిలియన్ డాలర్ల చెక్కును ఇచ్చాడు.	Tom handed Mary a check for half a million dollars.
దయచేసి తలుపు లాక్ చేయండి.	Please lock the door.
ఉపయోగకరమైన సలహా కోసం చాలా ధన్యవాదాలు.	Thank you very much for the useful advice.
మేము కొత్త కోచ్‌ను నియమించాము.	We've hired a new coach.
అది పాస్ అవుతుందని నేను ఖచ్చితంగా అనుకుంటున్నాను.	I'm sure it'll pass.
నేను ఈ మధ్యాహ్నం రావచ్చని అనుకుంటున్నాను.	I think I can come over this afternoon.
టామ్కు ఏమి జరిగిందో మనకు ఎప్పటికి తెలుస్తుందని నేను అనుకోను.	I don't think that we'll ever know what happened to Tom.
టామ్ ఎప్పుడైనా బోస్టన్‌కు వెళ్ళాడా అని నేను ఆశ్చర్యపోతున్నాను.	I wonder if Tom has ever been to Boston.
మేము వేగంగా ఇక్కడి నుండి బయటపడాలి.	We have to get out of here fast.
దేవుడు	God
నేను మిమ్మల్ని కొన్ని సలహాలు అడగాలనుకుంటున్నాను.	I'd like to ask you for some advice.
ఇది మంచి ఆలోచన.	That's a nice thought.
ఈ సాయంత్రం నాకు సమయం ఉండదు.	I won't have time this evening.
ఇది నా కఠినమైన హెచ్చరిక.	It is my strict warning.
అతను ఇంకా బతికే ఉంటే, అతను ఇప్పుడు చాలా వయస్సులో ఉంటాడు.	If he's still alive, he'd be very old by now.
మీరు నాకు సహాయం చేస్తే నేను పనిని అంగీకరిస్తాను.	I will accept the work, provided that you help me.
RRR ఒక ఎపిక్ యాక్షన్ డ్రామా మూవీ.	RRR is an epic action drama movie.
టామ్ కిటికీలోంచి చూస్తూ మేరీని చూశాడు.	Tom looked out the window and saw Mary.
మీకు బర్త్‌మార్క్ ఉందా?	Do you have a birthmark?
మూలం	Source
హిందీ భాషను హిందుస్థాన్ కి భాష అంటారు.	Hindi language is known as Hindustan ki Bhasha.
టామ్ ఒక నవల రాయడం ప్రారంభించాడు.	Tom has started writing a novel.
నిజం చెప్పడానికి ఎప్పుడూ వెనుకాడరు.	Never hesitate to tell the truth.
మీరు విందు కోసం ఉంటున్నారా?	Are you staying for dinner?
నేను అతని పేరు మీకు చెప్పడం లేదు.	I'm not telling you his name.
నేను మీకు చెప్పాను.	I'd have told you that.
పాలు పుల్లని రుచి చూస్తాయి.	The milk tastes sour.
మీరు గంభీరంగా ఉన్నట్లు నటించవచ్చు, కానీ మీరు ఫన్నీగా నటించలేరు.	You can pretend to be serious, but you can't pretend to be funny.
అది తెలివితక్కువ నియమం.	That's a stupid rule.
టామ్ డ్రైవ్ చేసేంత వయస్సు.	Tom is old enough to drive.
టామ్ సోమవారం ఇంటికి వస్తానని చెప్పాడు.	Tom told me that he'd be home on Monday.
టామ్ మేరీతో టెన్నిస్ ఆడాలనుకుంటున్నాడు.	Tom wants to play tennis with Mary.
నేను మీ వైపు చూడటం లేదు.	I wasn't looking at you.
అతను ఇప్పుడు తన తండ్రి ఉన్నంత ఎత్తులో ఉన్నాడు.	He is now almost as tall as his father is.
మీరు కుక్కకు ఆహారం ఇవ్వడం మర్చిపోయారా?	Did you forget to feed the dog?
సునీత తమిళం నేర్చుకోవడానికి ప్రయత్నిస్తోంది.	Suneetha is trying to learn Tamil.
ఎందుకు	Why
టామ్ మేరీ ఎవరో కూడా తెలియదు.	Tom didn't even know who Mary was.
